Achlya_ambisexualis_CBS10150	Heterokontophyta;Oomycetes;Saprolegniales;Saprolegniaceae;Achlya;Achlya;Achlya_ambisexualis
Achlya_ambisexualis_CBS38379	Heterokontophyta;Oomycetes;Saprolegniales;Saprolegniaceae;Achlya;Achlya;Achlya_ambisexualis
Achlya_americana_CBS10052	Heterokontophyta;Oomycetes;Saprolegniales;Saprolegniaceae;Achlya;Achlya;Achlya_americana
Achlya_aquatica_CBS10367	Heterokontophyta;Oomycetes;Saprolegniales;Saprolegniaceae;Achlya;Achlya;Achlya_aquatica
Achlya_bisexualis_A_CBS10350	Heterokontophyta;Oomycetes;Saprolegniales;Saprolegniaceae;Achlya;Achlya;Achlya_bisexualis_A
Achlya_bisexualis_B_CBS10262	Heterokontophyta;Oomycetes;Saprolegniales;Saprolegniaceae;Achlya;Achlya;Achlya_bisexualis_B
Achlya_bisexualis_CBS10042	Heterokontophyta;Oomycetes;Saprolegniales;Saprolegniaceae;Achlya;Achlya;Achlya_bisexualis
Achlya_caroliniana_CBS54467	Heterokontophyta;Oomycetes;Saprolegniales;Saprolegniaceae;Achlya;Achlya;Achlya_caroliniana
Achlya_colorata_CBS10237	Heterokontophyta;Oomycetes;Saprolegniales;Saprolegniaceae;Achlya;Achlya;Achlya_colorata
Achlya_colorata_CBS54567	Heterokontophyta;Oomycetes;Saprolegniales;Saprolegniaceae;Achlya;Achlya;Achlya_colorata
Achlya_conspicua_CBS10337	Heterokontophyta;Oomycetes;Saprolegniales;Saprolegniaceae;Achlya;Achlya;Achlya_conspicua
Achlya_dubia_CBS10138	Heterokontophyta;Oomycetes;Saprolegniales;Saprolegniaceae;Achlya;Achlya;Achlya_dubia
Achlya_dubia_CBS54667	Heterokontophyta;Oomycetes;Saprolegniales;Saprolegniaceae;Achlya;Achlya;Achlya_dubia
Achlya_flagellata_CBS10437	Heterokontophyta;Oomycetes;Saprolegniales;Saprolegniaceae;Achlya;Achlya;Achlya_flagellata
Achlya_flagellata_CBS10735	Heterokontophyta;Oomycetes;Saprolegniales;Saprolegniaceae;Achlya;Achlya;Achlya_flagellata
Achlya_flagellata_CBS52867	Heterokontophyta;Oomycetes;Saprolegniales;Saprolegniaceae;Achlya;Achlya;Achlya_flagellata
Achlya_glomerata_CBS10550	Heterokontophyta;Oomycetes;Saprolegniales;Saprolegniaceae;Achlya;Achlya;Achlya_glomerata
Achlya_heterosexualis_CBS41965	Heterokontophyta;Oomycetes;Saprolegniales;Saprolegniaceae;Achlya;Achlya;Achlya_heterosexualis
Achlya_heterosexualis_CBS42065	Heterokontophyta;Oomycetes;Saprolegniales;Saprolegniaceae;Achlya;Achlya;Achlya_heterosexualis
Achlya_oligocantha_CBS10144	Heterokontophyta;Oomycetes;Saprolegniales;Saprolegniaceae;Achlya;Achlya;Achlya_oligocantha
Achlya_papillosa_CBS10152	Heterokontophyta;Oomycetes;Saprolegniales;Saprolegniaceae;Achlya;Achlya;Achlya_papillosa
Achlya_racemosa_CBS10338	Heterokontophyta;Oomycetes;Saprolegniales;Saprolegniaceae;Achlya;Achlya;Achlya_racemosa
Achlya_racemosa_CBS54167	Heterokontophyta;Oomycetes;Saprolegniales;Saprolegniaceae;Achlya;Achlya;Achlya_racemosa
Achlya_racemosa_CBS57867	Heterokontophyta;Oomycetes;Saprolegniales;Saprolegniaceae;Achlya;Achlya;Achlya_racemosa
Achlya_radiosa_CBS54767	Heterokontophyta;Oomycetes;Saprolegniales;Saprolegniaceae;Achlya;Achlya;Achlya_radiosa
Achlya_recurva_CBS10850	Heterokontophyta;Oomycetes;Saprolegniales;Saprolegniaceae;Achlya;Achlya;Achlya_recurva
Achlya_sparrowii_CBS10249	Heterokontophyta;Oomycetes;Saprolegniales;Saprolegniaceae;Achlya;Achlya;Achlya_sparrowii
Achlya_spinosa_CBS57667	Heterokontophyta;Oomycetes;Saprolegniales;Saprolegniaceae;Achlya;Achlya;Achlya_spinosa
Albugo_candida_AC2V	Heterokontophyta;Oomycetes;Albuginales;Albuginaceae;Albugo;Albugo;Albugo_candida
Albugo_candida_AC7A	Heterokontophyta;Oomycetes;Albuginales;Albuginaceae;Albugo;Albugo;Albugo_candida
Aphanomyces_cladogamus_BR693	Heterokontophyta;Oomycetes;Saprolegniales;Saprolegniaceae;Aphanomyces;Aphanomyces;Aphanomyces_cladogamus
Aphanomyces_cladogamus_CBS10829	Heterokontophyta;Oomycetes;Saprolegniales;Saprolegniaceae;Aphanomyces;Aphanomyces;Aphanomyces_cladogamus
Aphanomyces_cladogamus_CBS69079	Heterokontophyta;Oomycetes;Saprolegniales;Saprolegniaceae;Aphanomyces;Aphanomyces;Aphanomyces_cladogamus
Aphanomyces_cochlioides_CBS47771	Heterokontophyta;Oomycetes;Saprolegniales;Saprolegniaceae;Aphanomyces;Aphanomyces;Aphanomyces_cochlioides
Aphanomyces_euteiches_BR694	Heterokontophyta;Oomycetes;Saprolegniales;Saprolegniaceae;Aphanomyces;Aphanomyces;Aphanomyces_euteiches
Aphanomyces_euteiches_CBS15473	Heterokontophyta;Oomycetes;Saprolegniales;Saprolegniaceae;Aphanomyces;Aphanomyces;Aphanomyces_euteiches
Aphanomyces_euteiches_CBS15573	Heterokontophyta;Oomycetes;Saprolegniales;Saprolegniaceae;Aphanomyces;Aphanomyces;Aphanomyces_euteiches
Aphanomyces_euteiches_CBS15673	Heterokontophyta;Oomycetes;Saprolegniales;Saprolegniaceae;Aphanomyces;Aphanomyces;Aphanomyces_euteiches
Aphanomyces_euteiches_CBS15773	Heterokontophyta;Oomycetes;Saprolegniales;Saprolegniaceae;Aphanomyces;Aphanomyces;Aphanomyces_euteiches
Aphanomyces_iridis_CBS52487	Heterokontophyta;Oomycetes;Saprolegniales;Saprolegniaceae;Aphanomyces;Aphanomyces;Aphanomyces_iridis
Aphanomyces_laevis_CBS47871	Heterokontophyta;Oomycetes;Saprolegniales;Saprolegniaceae;Aphanomyces;Aphanomyces;Aphanomyces_laevis
Aphanomyces_sp_CBS58385	Heterokontophyta;Oomycetes;Saprolegniales;Saprolegniaceae;Aphanomyces;Aphanomyces;Aphanomyces_sp
Apodachlya_brachynema_CBS18482	Heterokontophyta;Oomycetes;Leptomitales;Leptomitaceae;Apodachlya;Apodachlya;Apodachlya_brachynema
Apodachlya_brachynema_CBS55769	Heterokontophyta;Oomycetes;Leptomitales;Leptomitaceae;Apodachlya;Apodachlya;Apodachlya_brachynema
Apodachlya_minima_CBS18582	Heterokontophyta;Oomycetes;Leptomitales;Leptomitaceae;Apodachlya;Apodachlya;Apodachlya_minima
Basidiophora_entospora_HV119	Heterokontophyta;Oomycetes;Peronosporales;Peronosporaceae;Basidiophora;Basidiophora;Basidiophora_entospora
Brevilegnia_gracilis_CBS13137	Heterokontophyta;Oomycetes;Saprolegniales;Saprolegniaceae;Brevilegnia;Brevilegnia;Brevilegnia_gracilis
Brevilegnia_macrospora_CBS13237	Heterokontophyta;Oomycetes;Saprolegniales;Saprolegniaceae;Brevilegnia;Brevilegnia;Brevilegnia_macrospora
Brevilegnia_unisperma_var_delica_CBS14352	Heterokontophyta;Oomycetes;Saprolegniales;Saprolegniaceae;Brevilegnia;Brevilegnia;Brevilegnia_unisperma_var_delica
Brevilegnia_variabilis_CBS110006	Heterokontophyta;Oomycetes;Saprolegniales;Saprolegniaceae;Brevilegnia;Brevilegnia;Brevilegnia_variabilis
Eurychasma_dicksonii_CCAP4018	Heterokontophyta;Oomycetes;Myzocytiopsidales;Eurychasmataceae;Eurychasma;Eurychasma;Eurychasma_dicksonii
Halophytophthora_exoprolifera_CBS25293	Heterokontophyta;Oomycetes;Pythiales;Pythiaceae;Halopythophthora;Halophytophthora;Halophytophthora_exoprolifera
Halophytophthora_kandelii_CBS11191	Heterokontophyta;Oomycetes;Pythiales;Pythiaceae;Halopythophthora;Halophytophthora;Halophytophthora_kandelii
Halophytophthora_kandelii_CBS11391	Heterokontophyta;Oomycetes;Pythiales;Pythiaceae;Halopythophthora;Halophytophthora;Halophytophthora_kandelii
Halophytophthora_tartarea_CBS20895	Heterokontophyta;Oomycetes;Pythiales;Pythiaceae;Halopythophthora;Halophytophthora;Halophytophthora_tartarea
Hyaloperonospora_nesliae_HV203	Heterokontophyta;Oomycetes;Peronosporales;Peronosporaceae;Hyaloperonospora;Hyaloperonospora;Hyaloperonospora_nesliae
Hyaloperonospora_sisymbrii_sophiae_HV276	Heterokontophyta;Oomycetes;Peronosporales;Peronosporaceae;Hyaloperonospora;Hyaloperonospora;Hyaloperonospora_sisymbrii_sophiae
Lagenidium_caudatum_CBS58485	Heterokontophyta;Oomycetes;Lagenidiales;Lagenidiaceae;Lagenidium;Lagenidium;Lagenidium_caudatum
Lagenidium_giganteum_CBS58084	Heterokontophyta;Oomycetes;Lagenidiales;Lagenidiaceae;Lagenidium;Lagenidium;Lagenidium_giganteum
Leptolegnia_caudata_CBS68069	Heterokontophyta;Oomycetes;Saprolegniales;Saprolegniaceae;Leptolegnia;Leptolegnia;Leptolegnia_caudata
Leptolegnia_sp_CBS58285	Heterokontophyta;Oomycetes;Saprolegniales;Saprolegniaceae;Leptolegnia;Leptolegnia;Leptolegnia_sp
Peronospora_aparines_HV97	Heterokontophyta;Oomycetes;Peronosporales;Peronosporaceae;Peronospora;Peronospora;Peronospora_aparines
Peronospora_calotheca_HV81	Heterokontophyta;Oomycetes;Peronosporales;Peronosporaceae;Peronospora;Peronospora;Peronospora_calotheca
Peronospora_conglomerata_HV26	Heterokontophyta;Oomycetes;Peronosporales;Peronosporaceae;Peronospora;Peronospora;Peronospora_conglomerata
Peronospora_radii_HV22	Heterokontophyta;Oomycetes;Peronosporales;Peronosporaceae;Peronospora;Peronospora;Peronospora_radii
Peronospora_sherardiae_HV211	Heterokontophyta;Oomycetes;Peronosporales;Peronosporaceae;Peronospora;Peronospora;Peronospora_sherardiae
Peronospora_valerianellae_HV41	Heterokontophyta;Oomycetes;Peronosporales;Peronosporaceae;Peronospora;Peronospora;Peronospora_valerianellae
Peronospora_violae_HV34	Heterokontophyta;Oomycetes;Peronosporales;Peronosporaceae;Peronospora;Peronospora;Peronospora_violae
Phytopythium_aff_cucurbitacearum_Lev2210	Heterokontophyta;Oomycetes;Pythiales;Pythiaceae;Phytopythium;Phytopythium;Phytopythium_aff_cucurbitacearum
Phytopythium_aff_vexans_CBS26130	Heterokontophyta;Oomycetes;Pythiales;Pythiaceae;Phytopythium;Phytopythium;Phytopythium_aff_vexans
Phytopythium_aff_vexans_Lev3100	Heterokontophyta;Oomycetes;Pythiales;Pythiaceae;Phytopythium;Phytopythium;Phytopythium_aff_vexans
Phytopythium_boreale_CBS55188	Heterokontophyta;Oomycetes;Pythiales;Pythiaceae;Phytopythium;Phytopythium;Phytopythium_boreale
Phytopythium_carbonicum_CBS112544	Heterokontophyta;Oomycetes;Pythiales;Pythiaceae;Phytopythium;Phytopythium;Phytopythium_carbonicum
Phytopythium_chamaehyphon_CBS25930	Heterokontophyta;Oomycetes;Pythiales;Pythiaceae;Phytopythium;Phytopythium;Phytopythium_chamaehyphon
Phytopythium_citrinum_ADC9442	Heterokontophyta;Oomycetes;Pythiales;Pythiaceae;Phytopythium;Phytopythium;Phytopythium_citrinum
Phytopythium_citrinum_ADC9512	Heterokontophyta;Oomycetes;Pythiales;Pythiaceae;Phytopythium;Phytopythium;Phytopythium_citrinum
Phytopythium_citrinum_ADC9513	Heterokontophyta;Oomycetes;Pythiales;Pythiaceae;Phytopythium;Phytopythium;Phytopythium_citrinum
Phytopythium_citrinum_ADC9515	Heterokontophyta;Oomycetes;Pythiales;Pythiaceae;Phytopythium;Phytopythium;Phytopythium_citrinum
Phytopythium_citrinum_ADC9519	Heterokontophyta;Oomycetes;Pythiales;Pythiaceae;Phytopythium;Phytopythium;Phytopythium_citrinum
Phytopythium_citrinum_CBS119171	Heterokontophyta;Oomycetes;Pythiales;Pythiaceae;Phytopythium;Phytopythium;Phytopythium_citrinum
Phytopythium_cucurbitacearum_CBS74896	Heterokontophyta;Oomycetes;Pythiales;Pythiaceae;Phytopythium;Phytopythium;Phytopythium_cucurbitacearum
Phytopythium_helicoides_ADC9423	Heterokontophyta;Oomycetes;Pythiales;Pythiaceae;Phytopythium;Phytopythium;Phytopythium_helicoides
Phytopythium_helicoides_CBS16768	Heterokontophyta;Oomycetes;Pythiales;Pythiaceae;Phytopythium;Phytopythium;Phytopythium_helicoides
Phytopythium_helicoides_CBS28631	Heterokontophyta;Oomycetes;Pythiales;Pythiaceae;Phytopythium;Phytopythium;Phytopythium_helicoides
Phytopythium_litorale_BR896	Heterokontophyta;Oomycetes;Pythiales;Pythiaceae;Phytopythium;Phytopythium;Phytopythium_litorale
Phytopythium_litorale_CBS118360	Heterokontophyta;Oomycetes;Pythiales;Pythiaceae;Phytopythium;Phytopythium;Phytopythium_litorale
Phytopythium_litorale_CBS122662	Heterokontophyta;Oomycetes;Pythiales;Pythiaceae;Phytopythium;Phytopythium;Phytopythium_litorale
Phytopythium_litorale_Lev3002	Heterokontophyta;Oomycetes;Pythiales;Pythiaceae;Phytopythium;Phytopythium;Phytopythium_litorale
Phytopythium_litorale_Lev3006	Heterokontophyta;Oomycetes;Pythiales;Pythiaceae;Phytopythium;Phytopythium;Phytopythium_litorale
Phytopythium_litorale_Lev3011	Heterokontophyta;Oomycetes;Pythiales;Pythiaceae;Phytopythium;Phytopythium;Phytopythium_litorale
Phytopythium_litorale_Lev3012	Heterokontophyta;Oomycetes;Pythiales;Pythiaceae;Phytopythium;Phytopythium;Phytopythium_litorale
Phytopythium_litorale_Lev3013	Heterokontophyta;Oomycetes;Pythiales;Pythiaceae;Phytopythium;Phytopythium;Phytopythium_litorale
Phytopythium_megacarpum_CBS112351	Heterokontophyta;Oomycetes;Pythiales;Pythiaceae;Phytopythium;Phytopythium;Phytopythium_megacarpum
Phytopythium_montanum_ADC9762	Heterokontophyta;Oomycetes;Pythiales;Pythiaceae;Phytopythium;Phytopythium;Phytopythium_montanum
Phytopythium_montanum_ADC9766	Heterokontophyta;Oomycetes;Pythiales;Pythiaceae;Phytopythium;Phytopythium;Phytopythium_montanum
Phytopythium_montanum_CBS111349	Heterokontophyta;Oomycetes;Pythiales;Pythiaceae;Phytopythium;Phytopythium;Phytopythium_montanum
Phytopythium_oedochilum_CBS29237	Heterokontophyta;Oomycetes;Pythiales;Pythiaceae;Phytopythium;Phytopythium;Phytopythium_oedochilum
Phytopythium_oedochilum_DAOM229148	Heterokontophyta;Oomycetes;Pythiales;Pythiaceae;Phytopythium;Phytopythium;Phytopythium_oedochilum
Phytopythium_ostracodes_CBS76873	Heterokontophyta;Oomycetes;Pythiales;Pythiaceae;Phytopythium;Phytopythium;Phytopythium_ostracodes
Phytopythium_sindhum_DAOM238986	Heterokontophyta;Oomycetes;Pythiales;Pythiaceae;Phytopythium;Phytopythium;Phytopythium_sindhum
Phytopythium_sp_amazonianum_P8239	Heterokontophyta;Oomycetes;Pythiales;Pythiaceae;Phytopythium;Phytopythium;Phytopythium_sp_amazonianum
Phytopythium_sp_amazonianum_P8242	Heterokontophyta;Oomycetes;Pythiales;Pythiaceae;Phytopythium;Phytopythium;Phytopythium_sp_amazonianum
Phytopythium_sp_amazonianum_P8243	Heterokontophyta;Oomycetes;Pythiales;Pythiaceae;Phytopythium;Phytopythium;Phytopythium_sp_amazonianum
Phytopythium_sp_amazonianum_P8246	Heterokontophyta;Oomycetes;Pythiales;Pythiaceae;Phytopythium;Phytopythium;Phytopythium_sp_amazonianum
Phytopythium_sp_amazonianum_P8247	Heterokontophyta;Oomycetes;Pythiales;Pythiaceae;Phytopythium;Phytopythium;Phytopythium_sp_amazonianum
Phytopythium_sp_grandilobatum_CBS73894	Heterokontophyta;Oomycetes;Pythiales;Pythiaceae;Phytopythium;Phytopythium;Phytopythium_sp_grandilobatum
Phytopythium_sp_grandilobatum_CBS73994	Heterokontophyta;Oomycetes;Pythiales;Pythiaceae;Phytopythium;Phytopythium;Phytopythium_sp_grandilobatum
Phytopythium_sp_nov_ADC0004	Heterokontophyta;Oomycetes;Pythiales;Pythiaceae;Phytopythium;Phytopythium;Phytopythium_sp_nov
Phytopythium_sp_nov_ADC9517	Heterokontophyta;Oomycetes;Pythiales;Pythiaceae;Phytopythium;Phytopythium;Phytopythium_sp_nov
Phytopythium_sp_nov_ADC9520	Heterokontophyta;Oomycetes;Pythiales;Pythiaceae;Phytopythium;Phytopythium;Phytopythium_sp_nov
Phytopythium_vexans_CBS11980	Heterokontophyta;Oomycetes;Pythiales;Pythiaceae;Phytopythium;Phytopythium;Phytopythium_vexans
Phytopythium_vexans_CBS45562	Heterokontophyta;Oomycetes;Pythiales;Pythiaceae;Phytopythium;Phytopythium;Phytopythium_vexans
Phytopythium_vexans_P3980	Heterokontophyta;Oomycetes;Pythiales;Pythiaceae;Phytopythium;Phytopythium;Phytopythium_vexans
Phytophthora_aff_citricola_BR1073	Heterokontophyta;Oomycetes;Pythiales;Pythiaceae;Phytophthora;Phytophthora_Clade_2;Phytophthora_aff_citricola
Phytophthora_aff_meadii_CBS23530	Heterokontophyta;Oomycetes;Pythiales;Pythiaceae;Phytophthora;Phytophthora_Clade_2;Phytophthora_aff_meadii
Phytophthora_aff_meadii_CBS23828	Heterokontophyta;Oomycetes;Pythiales;Pythiaceae;Phytophthora;Phytophthora_Clade_2;Phytophthora_aff_meadii
Phytophthora_aff_primulae_P6817	Heterokontophyta;Oomycetes;Pythiales;Pythiaceae;Phytophthora;Phytophthora_Clade_8;Phytophthora_aff_primulae
Phytophthora_aff_rosacearum_P10678	Heterokontophyta;Oomycetes;Pythiales;Pythiaceae;Phytophthora;Phytophthora_Clade_6;Phytophthora_aff_rosacearum
Phytophthora_alni_392314	Heterokontophyta;Oomycetes;Pythiales;Pythiaceae;Phytophthora;Phytophthora_Clade_7;Phytophthora_alni
Phytophthora_alni_CBS117375	Heterokontophyta;Oomycetes;Pythiales;Pythiaceae;Phytophthora;Phytophthora_Clade_7;Phytophthora_alni
Phytophthora_alni_CBS117376	Heterokontophyta;Oomycetes;Pythiales;Pythiaceae;Phytophthora;Phytophthora_Clade_7;Phytophthora_alni
Phytophthora_alni_P10564	Heterokontophyta;Oomycetes;Pythiales;Pythiaceae;Phytophthora;Phytophthora_Clade_7;Phytophthora_alni
Phytophthora_alni_P11193	Heterokontophyta;Oomycetes;Pythiales;Pythiaceae;Phytophthora;Phytophthora_Clade_7;Phytophthora_alni
Phytophthora_alni_P11318	Heterokontophyta;Oomycetes;Pythiales;Pythiaceae;Phytophthora;Phytophthora_Clade_7;Phytophthora_alni
Phytophthora_alni_P16202	Heterokontophyta;Oomycetes;Pythiales;Pythiaceae;Phytophthora;Phytophthora_Clade_7;Phytophthora_alni
Phytophthora_alticola_P16052	Heterokontophyta;Oomycetes;Pythiales;Pythiaceae;Phytophthora;Phytophthora_Clade_4;Phytophthora_alticola
Phytophthora_arecae_CBS30562	Heterokontophyta;Oomycetes;Pythiales;Pythiaceae;Phytophthora;Phytophthora_Clade_4;Phytophthora_arecae
Phytophthora_austrocedrae_P15132	Heterokontophyta;Oomycetes;Pythiales;Pythiaceae;Phytophthora;Phytophthora_Clade_8;Phytophthora_austrocedrae
Phytophthora_austrocedrae_P16040	Heterokontophyta;Oomycetes;Pythiales;Pythiaceae;Phytophthora;Phytophthora_Clade_8;Phytophthora_austrocedrae
Phytophthora_avicenniae_CBS18885	Heterokontophyta;Oomycetes;Pythiales;Pythiaceae;Phytophthora;Halophytophthora;Phytophthora_avicenniae
Phytophthora_batemanensis_CBS67984	Heterokontophyta;Oomycetes;Pythiales;Pythiaceae;Phytophthora;Halophytophthora;Phytophthora_batemanensis
Phytophthora_bisheria_P10117	Heterokontophyta;Oomycetes;Pythiales;Pythiaceae;Phytophthora;Phytophthora_Clade_2;Phytophthora_bisheria
Phytophthora_bisheria_P11311	Heterokontophyta;Oomycetes;Pythiales;Pythiaceae;Phytophthora;Phytophthora_Clade_2;Phytophthora_bisheria
Phytophthora_bisheria_P7191	Heterokontophyta;Oomycetes;Pythiales;Pythiaceae;Phytophthora;Phytophthora_Clade_2;Phytophthora_bisheria
Phytophthora_boehmeriae_CBS29129	Heterokontophyta;Oomycetes;Pythiales;Pythiaceae;Phytophthora;Phytophthora_Clade_10;Phytophthora_boehmeriae
Phytophthora_boehmeriae_P1257	Heterokontophyta;Oomycetes;Pythiales;Pythiaceae;Phytophthora;Phytophthora_Clade_10;Phytophthora_boehmeriae
Phytophthora_boehmeriae_P1378	Heterokontophyta;Oomycetes;Pythiales;Pythiaceae;Phytophthora;Phytophthora_Clade_10;Phytophthora_boehmeriae
Phytophthora_boehmeriae_p43	Heterokontophyta;Oomycetes;Pythiales;Pythiaceae;Phytophthora;Phytophthora_Clade_10;Phytophthora_boehmeriae
Phytophthora_boehmeriae_P6950	Heterokontophyta;Oomycetes;Pythiales;Pythiaceae;Phytophthora;Phytophthora_Clade_10;Phytophthora_boehmeriae
Phytophthora_botryosa_CBS58169	Heterokontophyta;Oomycetes;Pythiales;Pythiaceae;Phytophthora;Phytophthora_Clade_2;Phytophthora_botryosa
Phytophthora_botryosa_P1044	Heterokontophyta;Oomycetes;Pythiales;Pythiaceae;Phytophthora;Phytophthora_Clade_2;Phytophthora_botryosa
Phytophthora_botryosa_P3425	Heterokontophyta;Oomycetes;Pythiales;Pythiaceae;Phytophthora;Phytophthora_Clade_2;Phytophthora_botryosa
Phytophthora_botryosa_p44	Heterokontophyta;Oomycetes;Pythiales;Pythiaceae;Phytophthora;Phytophthora_Clade_2;Phytophthora_botryosa
Phytophthora_botryosa_P6944	Heterokontophyta;Oomycetes;Pythiales;Pythiaceae;Phytophthora;Phytophthora_Clade_2;Phytophthora_botryosa
Phytophthora_botryosa_P6945	Heterokontophyta;Oomycetes;Pythiales;Pythiaceae;Phytophthora;Phytophthora_Clade_2;Phytophthora_botryosa
Phytophthora_brassicae_CBS112277	Heterokontophyta;Oomycetes;Pythiales;Pythiaceae;Phytophthora;Phytophthora_Clade_8;Phytophthora_brassicae
Phytophthora_brassicae_CBS17887	Heterokontophyta;Oomycetes;Pythiales;Pythiaceae;Phytophthora;Phytophthora_Clade_8;Phytophthora_brassicae
Phytophthora_brassicae_CBS18087	Heterokontophyta;Oomycetes;Pythiales;Pythiaceae;Phytophthora;Phytophthora_Clade_8;Phytophthora_brassicae
Phytophthora_brassicae_CBS21282	Heterokontophyta;Oomycetes;Pythiales;Pythiaceae;Phytophthora;Phytophthora_Clade_8;Phytophthora_brassicae
Phytophthora_brassicae_CBS68695	Heterokontophyta;Oomycetes;Pythiales;Pythiaceae;Phytophthora;Phytophthora_Clade_8;Phytophthora_brassicae
Phytophthora_brassicae_CBS78297	Heterokontophyta;Oomycetes;Pythiales;Pythiaceae;Phytophthora;Phytophthora_Clade_8;Phytophthora_brassicae
Phytophthora_brassicae_P10155	Heterokontophyta;Oomycetes;Pythiales;Pythiaceae;Phytophthora;Phytophthora_Clade_8;Phytophthora_brassicae
Phytophthora_brassicae_P3273	Heterokontophyta;Oomycetes;Pythiales;Pythiaceae;Phytophthora;Phytophthora_Clade_8;Phytophthora_brassicae
Phytophthora_cactorum_BR1067	Heterokontophyta;Oomycetes;Pythiales;Pythiaceae;Phytophthora;Phytophthora_Clade_1;Phytophthora_cactorum
Phytophthora_cactorum_BR194	Heterokontophyta;Oomycetes;Pythiales;Pythiaceae;Phytophthora;Phytophthora_Clade_1;Phytophthora_cactorum
Phytophthora_cactorum_BR672	Heterokontophyta;Oomycetes;Pythiales;Pythiaceae;Phytophthora;Phytophthora_Clade_1;Phytophthora_cactorum
Phytophthora_cactorum_BR673	Heterokontophyta;Oomycetes;Pythiales;Pythiaceae;Phytophthora;Phytophthora_Clade_1;Phytophthora_cactorum
Phytophthora_cactorum_BR675	Heterokontophyta;Oomycetes;Pythiales;Pythiaceae;Phytophthora;Phytophthora_Clade_1;Phytophthora_cactorum
Phytophthora_cactorum_CBS110121	Heterokontophyta;Oomycetes;Pythiales;Pythiaceae;Phytophthora;Phytophthora_Clade_1;Phytophthora_cactorum
Phytophthora_cactorum_CBS112275	Heterokontophyta;Oomycetes;Pythiales;Pythiaceae;Phytophthora;Phytophthora_Clade_1;Phytophthora_cactorum
Phytophthora_cactorum_CBS113344	Heterokontophyta;Oomycetes;Pythiales;Pythiaceae;Phytophthora;Phytophthora_Clade_1;Phytophthora_cactorum
Phytophthora_cactorum_CBS15188	Heterokontophyta;Oomycetes;Pythiales;Pythiaceae;Phytophthora;Phytophthora_Clade_1;Phytophthora_cactorum
Phytophthora_cactorum_CBS23130	Heterokontophyta;Oomycetes;Pythiales;Pythiaceae;Phytophthora;Phytophthora_Clade_1;Phytophthora_cactorum
Phytophthora_cactorum_CBS27937	Heterokontophyta;Oomycetes;Pythiales;Pythiaceae;Phytophthora;Phytophthora_Clade_1;Phytophthora_cactorum
Phytophthora_cactorum_CBS29429	Heterokontophyta;Oomycetes;Pythiales;Pythiaceae;Phytophthora;Phytophthora_Clade_1;Phytophthora_cactorum
Phytophthora_cactorum_P0714	Heterokontophyta;Oomycetes;Pythiales;Pythiaceae;Phytophthora;Phytophthora_Clade_1;Phytophthora_cactorum
Phytophthora_cactorum_P10365	Heterokontophyta;Oomycetes;Pythiales;Pythiaceae;Phytophthora;Phytophthora_Clade_1;Phytophthora_cactorum
Phytophthora_cajani_P3105	Heterokontophyta;Oomycetes;Pythiales;Pythiaceae;Phytophthora;Phytophthora_Clade_7;Phytophthora_cajani
Phytophthora_cambivora_CBS111329	Heterokontophyta;Oomycetes;Pythiales;Pythiaceae;Phytophthora;Phytophthora_Clade_7;Phytophthora_cambivora
Phytophthora_cambivora_CBS114085	Heterokontophyta;Oomycetes;Pythiales;Pythiaceae;Phytophthora;Phytophthora_Clade_7;Phytophthora_cambivora
Phytophthora_cambivora_CBS114086	Heterokontophyta;Oomycetes;Pythiales;Pythiaceae;Phytophthora;Phytophthora_Clade_7;Phytophthora_cambivora
Phytophthora_cambivora_CBS114087	Heterokontophyta;Oomycetes;Pythiales;Pythiaceae;Phytophthora;Phytophthora_Clade_7;Phytophthora_cambivora
Phytophthora_cambivora_CBS114093	Heterokontophyta;Oomycetes;Pythiales;Pythiaceae;Phytophthora;Phytophthora_Clade_7;Phytophthora_cambivora
Phytophthora_cambivora_CBS114094	Heterokontophyta;Oomycetes;Pythiales;Pythiaceae;Phytophthora;Phytophthora_Clade_7;Phytophthora_cambivora
Phytophthora_cambivora_CBS114095	Heterokontophyta;Oomycetes;Pythiales;Pythiaceae;Phytophthora;Phytophthora_Clade_7;Phytophthora_cambivora
Phytophthora_cambivora_CBS35678	Heterokontophyta;Oomycetes;Pythiales;Pythiaceae;Phytophthora;Phytophthora_Clade_7;Phytophthora_cambivora
Phytophthora_cambivora_P0592	Heterokontophyta;Oomycetes;Pythiales;Pythiaceae;Phytophthora;Phytophthora_Clade_7;Phytophthora_cambivora
Phytophthora_cambivora_p64	Heterokontophyta;Oomycetes;Pythiales;Pythiaceae;Phytophthora;Phytophthora_Clade_7;Phytophthora_cambivora
Phytophthora_capsici_CBS111333	Heterokontophyta;Oomycetes;Pythiales;Pythiaceae;Phytophthora;Phytophthora_Clade_2;Phytophthora_capsici
Phytophthora_capsici_CBS111334	Heterokontophyta;Oomycetes;Pythiales;Pythiaceae;Phytophthora;Phytophthora_Clade_2;Phytophthora_capsici
Phytophthora_capsici_CBS111335	Heterokontophyta;Oomycetes;Pythiales;Pythiaceae;Phytophthora;Phytophthora_Clade_2;Phytophthora_capsici
Phytophthora_capsici_CBS111336	Heterokontophyta;Oomycetes;Pythiales;Pythiaceae;Phytophthora;Phytophthora_Clade_2;Phytophthora_capsici
Phytophthora_capsici_CBS12823	Heterokontophyta;Oomycetes;Pythiales;Pythiaceae;Phytophthora;Phytophthora_Clade_2;Phytophthora_capsici
Phytophthora_capsici_CBS25493	Heterokontophyta;Oomycetes;Pythiales;Pythiaceae;Phytophthora;Phytophthora_Clade_2;Phytophthora_capsici
Phytophthora_capsici_CBS37072	Heterokontophyta;Oomycetes;Pythiales;Pythiaceae;Phytophthora;Phytophthora_Clade_2;Phytophthora_capsici
Phytophthora_capsici_CBS55488	Heterokontophyta;Oomycetes;Pythiales;Pythiaceae;Phytophthora;Phytophthora_Clade_2;Phytophthora_capsici
Phytophthora_capsici_P10386	Heterokontophyta;Oomycetes;Pythiales;Pythiaceae;Phytophthora;Phytophthora_Clade_2;Phytophthora_capsici
Phytophthora_capsici_P1319	Heterokontophyta;Oomycetes;Pythiales;Pythiaceae;Phytophthora;Phytophthora_Clade_2;Phytophthora_capsici
Phytophthora_capsici_P3375	Heterokontophyta;Oomycetes;Pythiales;Pythiaceae;Phytophthora;Phytophthora_Clade_2;Phytophthora_capsici
Phytophthora_capsici_P3605	Heterokontophyta;Oomycetes;Pythiales;Pythiaceae;Phytophthora;Phytophthora_Clade_2;Phytophthora_capsici
Phytophthora_capsici_p8	Heterokontophyta;Oomycetes;Pythiales;Pythiaceae;Phytophthora;Phytophthora_Clade_2;Phytophthora_capsici
Phytophthora_captiosa_P10719	Heterokontophyta;Oomycetes;Pythiales;Pythiaceae;Phytophthora;Phytophthora_Clade_9;Phytophthora_captiosa
Phytophthora_captiosa_P10720	Heterokontophyta;Oomycetes;Pythiales;Pythiaceae;Phytophthora;Phytophthora_Clade_9;Phytophthora_captiosa
Phytophthora_cinnamomi_CBS14422	Heterokontophyta;Oomycetes;Pythiales;Pythiaceae;Phytophthora;Phytophthora_Clade_7;Phytophthora_cinnamomi
Phytophthora_cinnamomi_CBS23230	Heterokontophyta;Oomycetes;Pythiales;Pythiaceae;Phytophthora;Phytophthora_Clade_7;Phytophthora_cinnamomi
Phytophthora_cinnamomi_CBS24960	Heterokontophyta;Oomycetes;Pythiales;Pythiaceae;Phytophthora;Phytophthora_Clade_7;Phytophthora_cinnamomi
Phytophthora_cinnamomi_CBS27055	Heterokontophyta;Oomycetes;Pythiales;Pythiaceae;Phytophthora;Phytophthora_Clade_7;Phytophthora_cinnamomi
Phytophthora_cinnamomi_CBS30436	Heterokontophyta;Oomycetes;Pythiales;Pythiaceae;Phytophthora;Phytophthora_Clade_7;Phytophthora_cinnamomi
Phytophthora_cinnamomi_CBS31949	Heterokontophyta;Oomycetes;Pythiales;Pythiaceae;Phytophthora;Phytophthora_Clade_7;Phytophthora_cinnamomi
Phytophthora_cinnamomi_CBS34172	Heterokontophyta;Oomycetes;Pythiales;Pythiaceae;Phytophthora;Phytophthora_Clade_7;Phytophthora_cinnamomi
Phytophthora_cinnamomi_CBS34272	Heterokontophyta;Oomycetes;Pythiales;Pythiaceae;Phytophthora;Phytophthora_Clade_7;Phytophthora_cinnamomi
Phytophthora_cinnamomi_CBS40248	Heterokontophyta;Oomycetes;Pythiales;Pythiaceae;Phytophthora;Phytophthora_Clade_7;Phytophthora_cinnamomi
Phytophthora_cinnamomi_CBS40348	Heterokontophyta;Oomycetes;Pythiales;Pythiaceae;Phytophthora;Phytophthora_Clade_7;Phytophthora_cinnamomi
Phytophthora_cinnamomi_P2100	Heterokontophyta;Oomycetes;Pythiales;Pythiaceae;Phytophthora;Phytophthora_Clade_7;Phytophthora_cinnamomi
Phytophthora_cinnamomi_P2121	Heterokontophyta;Oomycetes;Pythiales;Pythiaceae;Phytophthora;Phytophthora_Clade_7;Phytophthora_cinnamomi
Phytophthora_cinnamomi_P2160	Heterokontophyta;Oomycetes;Pythiales;Pythiaceae;Phytophthora;Phytophthora_Clade_7;Phytophthora_cinnamomi
Phytophthora_cinnamomi_P2301	Heterokontophyta;Oomycetes;Pythiales;Pythiaceae;Phytophthora;Phytophthora_Clade_7;Phytophthora_cinnamomi
Phytophthora_cinnamomi_P3232	Heterokontophyta;Oomycetes;Pythiales;Pythiaceae;Phytophthora;Phytophthora_Clade_7;Phytophthora_cinnamomi
Phytophthora_cinnamomi_P6305	Heterokontophyta;Oomycetes;Pythiales;Pythiaceae;Phytophthora;Phytophthora_Clade_7;Phytophthora_cinnamomi
Phytophthora_cinnamomi_var_parvispora_CBS41196	Heterokontophyta;Oomycetes;Pythiales;Pythiaceae;Phytophthora;Phytophthora_Clade_7;Phytophthora_cinnamomi_var_parvispora
Phytophthora_cinnamomi_var_parvispora_CBS41396	Heterokontophyta;Oomycetes;Pythiales;Pythiaceae;Phytophthora;Phytophthora_Clade_7;Phytophthora_cinnamomi_var_parvispora
Phytophthora_cinnamomi_var_parvispora_P7154	Heterokontophyta;Oomycetes;Pythiales;Pythiaceae;Phytophthora;Phytophthora_Clade_7;Phytophthora_cinnamomi_var_parvispora
Phytophthora_cinnamomi_var_parvispora_P8495	Heterokontophyta;Oomycetes;Pythiales;Pythiaceae;Phytophthora;Phytophthora_Clade_7;Phytophthora_cinnamomi_var_parvispora
Phytophthora_cinnamomi_var_robiniae_P16351	Heterokontophyta;Oomycetes;Pythiales;Pythiaceae;Phytophthora;Phytophthora_Clade_7;Phytophthora_cinnamomi_var_robiniae
Phytophthora_citricola_BR519	Heterokontophyta;Oomycetes;Pythiales;Pythiaceae;Phytophthora;Phytophthora_Clade_2;Phytophthora_citricola
Phytophthora_citricola_CBS22188	Heterokontophyta;Oomycetes;Pythiales;Pythiaceae;Phytophthora;Phytophthora_Clade_2;Phytophthora_citricola
Phytophthora_citricola_IIp52	Heterokontophyta;Oomycetes;Pythiales;Pythiaceae;Phytophthora;Phytophthora_Clade_2;Phytophthora_citricola
Phytophthora_citricola_P0716	Heterokontophyta;Oomycetes;Pythiales;Pythiaceae;Phytophthora;Phytophthora_Clade_2;Phytophthora_citricola
Phytophthora_citricola_P0767	Heterokontophyta;Oomycetes;Pythiales;Pythiaceae;Phytophthora;Phytophthora_Clade_2;Phytophthora_citricola
Phytophthora_citricola_P1805	Heterokontophyta;Oomycetes;Pythiales;Pythiaceae;Phytophthora;Phytophthora_Clade_2;Phytophthora_citricola
Phytophthora_multivora_P7902	Heterokontophyta;Oomycetes;Pythiales;Pythiaceae;Phytophthora;Phytophthora_Clade_2;Phytophthora_multivora
Phytophthora_citrophthora_136	Heterokontophyta;Oomycetes;Pythiales;Pythiaceae;Phytophthora;Phytophthora_Clade_2;Phytophthora_citrophthora
Phytophthora_citrophthora_CBS111338	Heterokontophyta;Oomycetes;Pythiales;Pythiaceae;Phytophthora;Phytophthora_Clade_2;Phytophthora_citrophthora
Phytophthora_citrophthora_CBS111339	Heterokontophyta;Oomycetes;Pythiales;Pythiaceae;Phytophthora;Phytophthora_Clade_2;Phytophthora_citrophthora
Phytophthora_citrophthora_CBS111726	Heterokontophyta;Oomycetes;Pythiales;Pythiaceae;Phytophthora;Phytophthora_Clade_2;Phytophthora_citrophthora
Phytophthora_citrophthora_CBS95087	Heterokontophyta;Oomycetes;Pythiales;Pythiaceae;Phytophthora;Phytophthora_Clade_2;Phytophthora_citrophthora
Phytophthora_citrophthora_P10341	Heterokontophyta;Oomycetes;Pythiales;Pythiaceae;Phytophthora;Phytophthora_Clade_2;Phytophthora_citrophthora
Phytophthora_citrophthora_P10368	Heterokontophyta;Oomycetes;Pythiales;Pythiaceae;Phytophthora;Phytophthora_Clade_2;Phytophthora_citrophthora
Phytophthora_clandestina_P3942	Heterokontophyta;Oomycetes;Pythiales;Pythiaceae;Phytophthora;Phytophthora_Clade_1;Phytophthora_clandestina
Phytophthora_clandestina_P3943	Heterokontophyta;Oomycetes;Pythiales;Pythiaceae;Phytophthora;Phytophthora_Clade_1;Phytophthora_clandestina
Phytophthora_colocasiae_P6290	Heterokontophyta;Oomycetes;Pythiales;Pythiaceae;Phytophthora;Phytophthora_Clade_2;Phytophthora_colocasiae
Phytophthora_colocasiae_P6317	Heterokontophyta;Oomycetes;Pythiales;Pythiaceae;Phytophthora;Phytophthora_Clade_2;Phytophthora_colocasiae
Phytophthora_cryptogea_BR521	Heterokontophyta;Oomycetes;Pythiales;Pythiaceae;Phytophthora;Phytophthora_Clade_8;Phytophthora_cryptogea
Phytophthora_cryptogea_BR589	Heterokontophyta;Oomycetes;Pythiales;Pythiaceae;Phytophthora;Phytophthora_Clade_8;Phytophthora_cryptogea
Phytophthora_cryptogea_BR682	Heterokontophyta;Oomycetes;Pythiales;Pythiaceae;Phytophthora;Phytophthora_Clade_8;Phytophthora_cryptogea
Phytophthora_cryptogea_CBS11319	Heterokontophyta;Oomycetes;Pythiales;Pythiaceae;Phytophthora;Phytophthora_Clade_8;Phytophthora_cryptogea
Phytophthora_cryptogea_CBS114074	Heterokontophyta;Oomycetes;Pythiales;Pythiaceae;Phytophthora;Phytophthora_Clade_8;Phytophthora_cryptogea
Phytophthora_cryptogea_CBS29035	Heterokontophyta;Oomycetes;Pythiales;Pythiaceae;Phytophthora;Phytophthora_Clade_8;Phytophthora_cryptogea
Phytophthora_cryptogea_CBS41871	Heterokontophyta;Oomycetes;Pythiales;Pythiaceae;Phytophthora;Phytophthora_Clade_8;Phytophthora_cryptogea
Phytophthora_cryptogea_fsp_begoniae_CBS46881	Heterokontophyta;Oomycetes;Pythiales;Pythiaceae;Phytophthora;Phytophthora_Clade_8;Phytophthora_cryptogea_fsp_begoniae
Phytophthora_cryptogea_Lev1802	Heterokontophyta;Oomycetes;Pythiales;Pythiaceae;Phytophthora;Phytophthora_Clade_8;Phytophthora_cryptogea
Phytophthora_cryptogea_P10705	Heterokontophyta;Oomycetes;Pythiales;Pythiaceae;Phytophthora;Phytophthora_Clade_8;Phytophthora_cryptogea
Phytophthora_cryptogea_P1088	Heterokontophyta;Oomycetes;Pythiales;Pythiaceae;Phytophthora;Phytophthora_Clade_8;Phytophthora_cryptogea
Phytophthora_cryptogea_P11822	Heterokontophyta;Oomycetes;Pythiales;Pythiaceae;Phytophthora;Phytophthora_Clade_8;Phytophthora_cryptogea
Phytophthora_cryptogea_p13	Heterokontophyta;Oomycetes;Pythiales;Pythiaceae;Phytophthora;Phytophthora_Clade_8;Phytophthora_cryptogea
Phytophthora_cryptogea_P16165	Heterokontophyta;Oomycetes;Pythiales;Pythiaceae;Phytophthora;Phytophthora_Clade_8;Phytophthora_cryptogea
Phytophthora_cryptogea_P1693	Heterokontophyta;Oomycetes;Pythiales;Pythiaceae;Phytophthora;Phytophthora_Clade_8;Phytophthora_cryptogea
Phytophthora_cryptogea_P1739	Heterokontophyta;Oomycetes;Pythiales;Pythiaceae;Phytophthora;Phytophthora_Clade_8;Phytophthora_cryptogea
Phytophthora_cryptogea_P1810	Heterokontophyta;Oomycetes;Pythiales;Pythiaceae;Phytophthora;Phytophthora_Clade_8;Phytophthora_cryptogea
Phytophthora_cryptogea_P3103	Heterokontophyta;Oomycetes;Pythiales;Pythiaceae;Phytophthora;Phytophthora_Clade_8;Phytophthora_cryptogea
Phytophthora_cryptogea_P3700	Heterokontophyta;Oomycetes;Pythiales;Pythiaceae;Phytophthora;Phytophthora_Clade_8;Phytophthora_cryptogea
Phytophthora_cryptogea_P3876	Heterokontophyta;Oomycetes;Pythiales;Pythiaceae;Phytophthora;Phytophthora_Clade_8;Phytophthora_cryptogea
Phytophthora_drechsleri_P10331	Heterokontophyta;Oomycetes;Pythiales;Pythiaceae;Phytophthora;Phytophthora_Clade_8;Phytophthora_drechsleri
Phytophthora_drechsleri_P1087	Heterokontophyta;Oomycetes;Pythiales;Pythiaceae;Phytophthora;Phytophthora_Clade_8;Phytophthora_drechsleri
Phytophthora_drechsleri_P11638	Heterokontophyta;Oomycetes;Pythiales;Pythiaceae;Phytophthora;Phytophthora_Clade_8;Phytophthora_drechsleri
Phytophthora_epistomium_CBS59085	Heterokontophyta;Oomycetes;Pythiales;Pythiaceae;Phytophthora;Pythium_Clade_C;Phytophthora_epistomium
Phytophthora_erythroseptica_BR464	Heterokontophyta;Oomycetes;Pythiales;Pythiaceae;Phytophthora;Phytophthora_Clade_8;Phytophthora_erythroseptica
Phytophthora_erythroseptica_BR664	Heterokontophyta;Oomycetes;Pythiales;Pythiaceae;Phytophthora;Phytophthora_Clade_8;Phytophthora_erythroseptica
Phytophthora_erythroseptica_CBS111343	Heterokontophyta;Oomycetes;Pythiales;Pythiaceae;Phytophthora;Phytophthora_Clade_8;Phytophthora_erythroseptica
Phytophthora_erythroseptica_CBS12923	Heterokontophyta;Oomycetes;Pythiales;Pythiaceae;Phytophthora;Phytophthora_Clade_8;Phytophthora_erythroseptica
Phytophthora_erythroseptica_CBS23330	Heterokontophyta;Oomycetes;Pythiales;Pythiaceae;Phytophthora;Phytophthora_Clade_8;Phytophthora_erythroseptica
Phytophthora_erythroseptica_CBS95187	Heterokontophyta;Oomycetes;Pythiales;Pythiaceae;Phytophthora;Phytophthora_Clade_8;Phytophthora_erythroseptica
Phytophthora_erythroseptica_CBS95687	Heterokontophyta;Oomycetes;Pythiales;Pythiaceae;Phytophthora;Phytophthora_Clade_8;Phytophthora_erythroseptica
Phytophthora_erythroseptica_P0340	Heterokontophyta;Oomycetes;Pythiales;Pythiaceae;Phytophthora;Phytophthora_Clade_8;Phytophthora_erythroseptica
Phytophthora_erythroseptica_P10382	Heterokontophyta;Oomycetes;Pythiales;Pythiaceae;Phytophthora;Phytophthora_Clade_8;Phytophthora_erythroseptica
Phytophthora_erythroseptica_p50	Heterokontophyta;Oomycetes;Pythiales;Pythiaceae;Phytophthora;Phytophthora_Clade_8;Phytophthora_erythroseptica
Phytophthora_europaea_BR1072	Heterokontophyta;Oomycetes;Pythiales;Pythiaceae;Phytophthora;Phytophthora_Clade_7;Phytophthora_europaea
Phytophthora_europaea_P10324	Heterokontophyta;Oomycetes;Pythiales;Pythiaceae;Phytophthora;Phytophthora_Clade_7;Phytophthora_europaea
Phytophthora_fallax_P10722	Heterokontophyta;Oomycetes;Pythiales;Pythiaceae;Phytophthora;Phytophthora_Clade_9;Phytophthora_fallax
Phytophthora_fallax_P10723	Heterokontophyta;Oomycetes;Pythiales;Pythiaceae;Phytophthora;Phytophthora_Clade_9;Phytophthora_fallax
Phytophthora_fallax_P10725	Heterokontophyta;Oomycetes;Pythiales;Pythiaceae;Phytophthora;Phytophthora_Clade_9;Phytophthora_fallax
Phytophthora_foliorum_P10969	Heterokontophyta;Oomycetes;Pythiales;Pythiaceae;Phytophthora;Phytophthora_Clade_8;Phytophthora_foliorum
Phytophthora_foliorum_P10971	Heterokontophyta;Oomycetes;Pythiales;Pythiaceae;Phytophthora;Phytophthora_Clade_8;Phytophthora_foliorum
Phytophthora_fragariae_CBS20946	Heterokontophyta;Oomycetes;Pythiales;Pythiaceae;Phytophthora;Phytophthora_Clade_7;Phytophthora_fragariae
Phytophthora_fragariae_CBS30962	Heterokontophyta;Oomycetes;Pythiales;Pythiaceae;Phytophthora;Phytophthora_Clade_7;Phytophthora_fragariae
Phytophthora_fragariae_P11808	Heterokontophyta;Oomycetes;Pythiales;Pythiaceae;Phytophthora;Phytophthora_Clade_7;Phytophthora_fragariae
Phytophthora_fragariae_P1435	Heterokontophyta;Oomycetes;Pythiales;Pythiaceae;Phytophthora;Phytophthora_Clade_7;Phytophthora_fragariae
Phytophthora_fragariae_P3820	Heterokontophyta;Oomycetes;Pythiales;Pythiaceae;Phytophthora;Phytophthora_Clade_7;Phytophthora_fragariae
Phytophthora_fragariae_P6406	Heterokontophyta;Oomycetes;Pythiales;Pythiaceae;Phytophthora;Phytophthora_Clade_7;Phytophthora_fragariae
Phytophthora_frigida_P16051	Heterokontophyta;Oomycetes;Pythiales;Pythiaceae;Phytophthora;Phytophthora_Clade_2;Phytophthora_frigida
Phytophthora_frigida_P16053	Heterokontophyta;Oomycetes;Pythiales;Pythiaceae;Phytophthora;Phytophthora_Clade_2;Phytophthora_frigida
Phytophthora_frigida_P16054	Heterokontophyta;Oomycetes;Pythiales;Pythiaceae;Phytophthora;Phytophthora_Clade_2;Phytophthora_frigida
Phytophthora_frigida_P16059	Heterokontophyta;Oomycetes;Pythiales;Pythiaceae;Phytophthora;Phytophthora_Clade_2;Phytophthora_frigida
Phytophthora_gonapodyides_345174	Heterokontophyta;Oomycetes;Pythiales;Pythiaceae;Phytophthora;Phytophthora_Clade_6;Phytophthora_gonapodyides
Phytophthora_gonapodyides_CBS113346	Heterokontophyta;Oomycetes;Pythiales;Pythiaceae;Phytophthora;Phytophthora_Clade_6;Phytophthora_gonapodyides
Phytophthora_gonapodyides_CBS117380	Heterokontophyta;Oomycetes;Pythiales;Pythiaceae;Phytophthora;Phytophthora_Clade_6;Phytophthora_gonapodyides
Phytophthora_gonapodyides_CBS36379	Heterokontophyta;Oomycetes;Pythiales;Pythiaceae;Phytophthora;Phytophthora_Clade_6;Phytophthora_gonapodyides
Phytophthora_gonapodyides_CBS55467	Heterokontophyta;Oomycetes;Pythiales;Pythiaceae;Phytophthora;Phytophthora_Clade_6;Phytophthora_gonapodyides
Phytophthora_gonapodyides_P7050	Heterokontophyta;Oomycetes;Pythiales;Pythiaceae;Phytophthora;Phytophthora_Clade_6;Phytophthora_gonapodyides
Phytophthora_hedraiandra_CBS118732	Heterokontophyta;Oomycetes;Pythiales;Pythiaceae;Phytophthora;Phytophthora_Clade_1;Phytophthora_hedraiandra
Phytophthora_hedraiandra_P11678	Heterokontophyta;Oomycetes;Pythiales;Pythiaceae;Phytophthora;Phytophthora_Clade_1;Phytophthora_hedraiandra
Phytophthora_heveae_CBS29629	Heterokontophyta;Oomycetes;Pythiales;Pythiaceae;Phytophthora;Phytophthora_Clade_5;Phytophthora_heveae
Phytophthora_heveae_P0578	Heterokontophyta;Oomycetes;Pythiales;Pythiaceae;Phytophthora;Phytophthora_Clade_5;Phytophthora_heveae
Phytophthora_heveae_P1000	Heterokontophyta;Oomycetes;Pythiales;Pythiaceae;Phytophthora;Phytophthora_Clade_5;Phytophthora_heveae
Phytophthora_heveae_p28	Heterokontophyta;Oomycetes;Pythiales;Pythiaceae;Phytophthora;Phytophthora_Clade_5;Phytophthora_heveae
Phytophthora_heveae_P3428	Heterokontophyta;Oomycetes;Pythiales;Pythiaceae;Phytophthora;Phytophthora_Clade_5;Phytophthora_heveae
Phytophthora_heveae_P8240	Heterokontophyta;Oomycetes;Pythiales;Pythiaceae;Phytophthora;Phytophthora_Clade_5;Phytophthora_heveae
Phytophthora_hibernalis_CBS119904	Heterokontophyta;Oomycetes;Pythiales;Pythiaceae;Phytophthora;Phytophthora_Clade_8;Phytophthora_hibernalis
Phytophthora_hibernalis_CBS52277	Heterokontophyta;Oomycetes;Pythiales;Pythiaceae;Phytophthora;Phytophthora_Clade_8;Phytophthora_hibernalis
Phytophthora_hibernalis_P3822	Heterokontophyta;Oomycetes;Pythiales;Pythiaceae;Phytophthora;Phytophthora_Clade_8;Phytophthora_hibernalis
Phytophthora_himalayensis_CBS35759	Heterokontophyta;Oomycetes;Pythiales;Pythiaceae;Phytophthora;Phytophthora_Clade_8;Phytophthora_himalayensis
Phytophthora_humicola_CBS114082	Heterokontophyta;Oomycetes;Pythiales;Pythiaceae;Phytophthora;Phytophthora_Clade_6;Phytophthora_humicola
Phytophthora_humicola_CBS114083	Heterokontophyta;Oomycetes;Pythiales;Pythiaceae;Phytophthora;Phytophthora_Clade_6;Phytophthora_humicola
Phytophthora_humicola_CBS20081	Heterokontophyta;Oomycetes;Pythiales;Pythiaceae;Phytophthora;Phytophthora_Clade_6;Phytophthora_humicola
Phytophthora_humicola_P3826	Heterokontophyta;Oomycetes;Pythiales;Pythiaceae;Phytophthora;Phytophthora_Clade_6;Phytophthora_humicola
Phytophthora_humicola_P6701	Heterokontophyta;Oomycetes;Pythiales;Pythiaceae;Phytophthora;Phytophthora_Clade_6;Phytophthora_humicola
Phytophthora_idaei_CBS96895	Heterokontophyta;Oomycetes;Pythiales;Pythiaceae;Phytophthora;Phytophthora_Clade_1;Phytophthora_idaei
Phytophthora_idaei_P6767	Heterokontophyta;Oomycetes;Pythiales;Pythiaceae;Phytophthora;Phytophthora_Clade_1;Phytophthora_idaei
Phytophthora_ilicis_P3939	Heterokontophyta;Oomycetes;Pythiales;Pythiaceae;Phytophthora;Phytophthora_Clade_3;Phytophthora_ilicis
Phytophthora_ilicis_P6098	Heterokontophyta;Oomycetes;Pythiales;Pythiaceae;Phytophthora;Phytophthora_Clade_3;Phytophthora_ilicis
Phytophthora_ilicis_P6099	Heterokontophyta;Oomycetes;Pythiales;Pythiaceae;Phytophthora;Phytophthora_Clade_3;Phytophthora_ilicis
Phytophthora_ilicis_P6860	Heterokontophyta;Oomycetes;Pythiales;Pythiaceae;Phytophthora;Phytophthora_Clade_3;Phytophthora_ilicis
Phytophthora_infestans_CBS36651	Heterokontophyta;Oomycetes;Pythiales;Pythiaceae;Phytophthora;Phytophthora_Clade_1;Phytophthora_infestans
Phytophthora_infestans_P10650	Heterokontophyta;Oomycetes;Pythiales;Pythiaceae;Phytophthora;Phytophthora_Clade_1;Phytophthora_infestans
Phytophthora_infestans_P12022	Heterokontophyta;Oomycetes;Pythiales;Pythiaceae;Phytophthora;Phytophthora_Clade_1;Phytophthora_infestans
Phytophthora_infestans_P13198	Heterokontophyta;Oomycetes;Pythiales;Pythiaceae;Phytophthora;Phytophthora_Clade_1;Phytophthora_infestans
Phytophthora_infestans_P15168	Heterokontophyta;Oomycetes;Pythiales;Pythiaceae;Phytophthora;Phytophthora_Clade_1;Phytophthora_infestans
Phytophthora_infestans_P15938	Heterokontophyta;Oomycetes;Pythiales;Pythiaceae;Phytophthora;Phytophthora_Clade_1;Phytophthora_infestans
Phytophthora_infestans_P15941	Heterokontophyta;Oomycetes;Pythiales;Pythiaceae;Phytophthora;Phytophthora_Clade_1;Phytophthora_infestans
Phytophthora_inflata_p122	Heterokontophyta;Oomycetes;Pythiales;Pythiaceae;Phytophthora;Phytophthora_Clade_2;Phytophthora_inflata
Phytophthora_insolita_288805	Heterokontophyta;Oomycetes;Pythiales;Pythiaceae;Phytophthora;Phytophthora_Clade_9;Phytophthora_insolita
Phytophthora_insolita_P6195	Heterokontophyta;Oomycetes;Pythiales;Pythiaceae;Phytophthora;Phytophthora_Clade_9;Phytophthora_insolita
Phytophthora_insolita_P6703	Heterokontophyta;Oomycetes;Pythiales;Pythiaceae;Phytophthora;Phytophthora_Clade_9;Phytophthora_insolita
Phytophthora_inundata_BR332	Heterokontophyta;Oomycetes;Pythiales;Pythiaceae;Phytophthora;Phytophthora_Clade_6;Phytophthora_inundata
Phytophthora_inundata_CBS21585	Heterokontophyta;Oomycetes;Pythiales;Pythiaceae;Phytophthora;Phytophthora_Clade_6;Phytophthora_inundata
Phytophthora_inundata_CBS21685	Heterokontophyta;Oomycetes;Pythiales;Pythiaceae;Phytophthora;Phytophthora_Clade_6;Phytophthora_inundata
Phytophthora_inundata_P8478	Heterokontophyta;Oomycetes;Pythiales;Pythiaceae;Phytophthora;Phytophthora_Clade_6;Phytophthora_inundata
Phytophthora_inundata_P8479	Heterokontophyta;Oomycetes;Pythiales;Pythiaceae;Phytophthora;Phytophthora_Clade_6;Phytophthora_inundata
Phytophthora_inundata_P8619	Heterokontophyta;Oomycetes;Pythiales;Pythiaceae;Phytophthora;Phytophthora_Clade_6;Phytophthora_inundata
Phytophthora_ipomoeae_P10225	Heterokontophyta;Oomycetes;Pythiales;Pythiaceae;Phytophthora;Phytophthora_Clade_1;Phytophthora_ipomoeae
Phytophthora_ipomoeae_P10226	Heterokontophyta;Oomycetes;Pythiales;Pythiaceae;Phytophthora;Phytophthora_Clade_1;Phytophthora_ipomoeae
Phytophthora_ipomoeae_P10227	Heterokontophyta;Oomycetes;Pythiales;Pythiaceae;Phytophthora;Phytophthora_Clade_1;Phytophthora_ipomoeae
Phytophthora_ipomoeae_PRI810	Heterokontophyta;Oomycetes;Pythiales;Pythiaceae;Phytophthora;Phytophthora_Clade_1;Phytophthora_ipomoeae
Phytophthora_iranica_CBS37472	Heterokontophyta;Oomycetes;Pythiales;Pythiaceae;Phytophthora;Phytophthora_Clade_1;Phytophthora_iranica
Phytophthora_iranica_P3882	Heterokontophyta;Oomycetes;Pythiales;Pythiaceae;Phytophthora;Phytophthora_Clade_1;Phytophthora_iranica
Phytophthora_katsurae_CBS58785	Heterokontophyta;Oomycetes;Pythiales;Pythiaceae;Phytophthora;Phytophthora_Clade_5;Phytophthora_katsurae
Phytophthora_katsurae_P10187	Heterokontophyta;Oomycetes;Pythiales;Pythiaceae;Phytophthora;Phytophthora_Clade_5;Phytophthora_katsurae
Phytophthora_katsurae_P3389	Heterokontophyta;Oomycetes;Pythiales;Pythiaceae;Phytophthora;Phytophthora_Clade_5;Phytophthora_katsurae
Phytophthora_katsurae_p45	Heterokontophyta;Oomycetes;Pythiales;Pythiaceae;Phytophthora;Phytophthora_Clade_5;Phytophthora_katsurae
Phytophthora_katsurae_P6921	Heterokontophyta;Oomycetes;Pythiales;Pythiaceae;Phytophthora;Phytophthora_Clade_5;Phytophthora_katsurae
Phytophthora_kernoviae_393172	Heterokontophyta;Oomycetes;Pythiales;Pythiaceae;Phytophthora;Phytophthora_Clade_10;Phytophthora_kernoviae
Phytophthora_kernoviae_P10671	Heterokontophyta;Oomycetes;Pythiales;Pythiaceae;Phytophthora;Phytophthora_Clade_10;Phytophthora_kernoviae
Phytophthora_kernoviae_P10681	Heterokontophyta;Oomycetes;Pythiales;Pythiaceae;Phytophthora;Phytophthora_Clade_10;Phytophthora_kernoviae
Phytophthora_kernoviae_P10958	Heterokontophyta;Oomycetes;Pythiales;Pythiaceae;Phytophthora;Phytophthora_Clade_10;Phytophthora_kernoviae
Phytophthora_kernoviae_PRI712	Heterokontophyta;Oomycetes;Pythiales;Pythiaceae;Phytophthora;Phytophthora_Clade_10;Phytophthora_kernoviae
Phytophthora_kernoviae_PRI713	Heterokontophyta;Oomycetes;Pythiales;Pythiaceae;Phytophthora;Phytophthora_Clade_10;Phytophthora_kernoviae
Phytophthora_kernoviae_PRI714	Heterokontophyta;Oomycetes;Pythiales;Pythiaceae;Phytophthora;Phytophthora_Clade_10;Phytophthora_kernoviae
Phytophthora_kernoviae_PRI715	Heterokontophyta;Oomycetes;Pythiales;Pythiaceae;Phytophthora;Phytophthora_Clade_10;Phytophthora_kernoviae
Phytophthora_lateralis_Lev1213	Heterokontophyta;Oomycetes;Pythiales;Pythiaceae;Phytophthora;Phytophthora_Clade_8;Phytophthora_lateralis
Phytophthora_lateralis_p51	Heterokontophyta;Oomycetes;Pythiales;Pythiaceae;Phytophthora;Phytophthora_Clade_8;Phytophthora_lateralis
Phytophthora_litchii_BR892	Heterokontophyta;Oomycetes;Pythiales;Pythiaceae;Phytophthora;Phytophthora_Clade_4;Phytophthora_litchii
Phytophthora_litchii_BR893	Heterokontophyta;Oomycetes;Pythiales;Pythiaceae;Phytophthora;Phytophthora_Clade_4;Phytophthora_litchii
Phytophthora_litchii_CBS10081	Heterokontophyta;Oomycetes;Pythiales;Pythiaceae;Phytophthora;Phytophthora_Clade_4;Phytophthora_litchii
Phytophthora_macrochlamydospora_351473	Heterokontophyta;Oomycetes;Pythiales;Pythiaceae;Phytophthora;Phytophthora_Clade_9;Phytophthora_macrochlamydospora
Phytophthora_macrochlamydospora_P10267	Heterokontophyta;Oomycetes;Pythiales;Pythiaceae;Phytophthora;Phytophthora_Clade_9;Phytophthora_macrochlamydospora
Phytophthora_macrochlamydospora_P8017	Heterokontophyta;Oomycetes;Pythiales;Pythiaceae;Phytophthora;Phytophthora_Clade_9;Phytophthora_macrochlamydospora
Phytophthora_meadii_CBS21988	Heterokontophyta;Oomycetes;Pythiales;Pythiaceae;Phytophthora;Phytophthora_Clade_2;Phytophthora_meadii
Phytophthora_meadii_P6128	Heterokontophyta;Oomycetes;Pythiales;Pythiaceae;Phytophthora;Phytophthora_Clade_2;Phytophthora_meadii
Phytophthora_meadii_p75	Heterokontophyta;Oomycetes;Pythiales;Pythiaceae;Phytophthora;Phytophthora_Clade_2;Phytophthora_meadii
Phytophthora_medicaginis_BR610	Heterokontophyta;Oomycetes;Pythiales;Pythiaceae;Phytophthora;Phytophthora_Clade_8;Phytophthora_medicaginis
Phytophthora_medicaginis_BR611	Heterokontophyta;Oomycetes;Pythiales;Pythiaceae;Phytophthora;Phytophthora_Clade_8;Phytophthora_medicaginis
Phytophthora_medicaginis_BR622	Heterokontophyta;Oomycetes;Pythiales;Pythiaceae;Phytophthora;Phytophthora_Clade_8;Phytophthora_medicaginis
Phytophthora_medicaginis_CBS117685	Heterokontophyta;Oomycetes;Pythiales;Pythiaceae;Phytophthora;Phytophthora_Clade_8;Phytophthora_medicaginis
Phytophthora_medicaginis_P10127	Heterokontophyta;Oomycetes;Pythiales;Pythiaceae;Phytophthora;Phytophthora_Clade_8;Phytophthora_medicaginis
Phytophthora_megakarya_P1664	Heterokontophyta;Oomycetes;Pythiales;Pythiaceae;Phytophthora;Phytophthora_Clade_4;Phytophthora_megakarya
Phytophthora_megakarya_P1672	Heterokontophyta;Oomycetes;Pythiales;Pythiaceae;Phytophthora;Phytophthora_Clade_4;Phytophthora_megakarya
Phytophthora_megakarya_p42	Heterokontophyta;Oomycetes;Pythiales;Pythiaceae;Phytophthora;Phytophthora_Clade_4;Phytophthora_megakarya
Phytophthora_megakarya_P8516	Heterokontophyta;Oomycetes;Pythiales;Pythiaceae;Phytophthora;Phytophthora_Clade_4;Phytophthora_megakarya
Phytophthora_megasperma_BR395	Heterokontophyta;Oomycetes;Pythiales;Pythiaceae;Phytophthora;Phytophthora_Clade_6;Phytophthora_megasperma
Phytophthora_megasperma_BR396	Heterokontophyta;Oomycetes;Pythiales;Pythiaceae;Phytophthora;Phytophthora_Clade_6;Phytophthora_megasperma
Phytophthora_megasperma_BR398	Heterokontophyta;Oomycetes;Pythiales;Pythiaceae;Phytophthora;Phytophthora_Clade_6;Phytophthora_megasperma
Phytophthora_megasperma_BR528	Heterokontophyta;Oomycetes;Pythiales;Pythiaceae;Phytophthora;Phytophthora_Clade_6;Phytophthora_megasperma
Phytophthora_megasperma_BR529	Heterokontophyta;Oomycetes;Pythiales;Pythiaceae;Phytophthora;Phytophthora_Clade_6;Phytophthora_megasperma
Phytophthora_megasperma_CBS30636	Heterokontophyta;Oomycetes;Pythiales;Pythiaceae;Phytophthora;Phytophthora_Clade_6;Phytophthora_megasperma
Phytophthora_megasperma_CBS40272	Heterokontophyta;Oomycetes;Pythiales;Pythiaceae;Phytophthora;Phytophthora_Clade_6;Phytophthora_megasperma
Phytophthora_megasperma_Ip81	Heterokontophyta;Oomycetes;Pythiales;Pythiaceae;Phytophthora;Phytophthora_Clade_6;Phytophthora_megasperma
Phytophthora_megasperma_P10340	Heterokontophyta;Oomycetes;Pythiales;Pythiaceae;Phytophthora;Phytophthora_Clade_6;Phytophthora_megasperma
Phytophthora_megasperma_P1679	Heterokontophyta;Oomycetes;Pythiales;Pythiaceae;Phytophthora;Phytophthora_Clade_6;Phytophthora_megasperma
Phytophthora_megasperma_P3136	Heterokontophyta;Oomycetes;Pythiales;Pythiaceae;Phytophthora;Phytophthora_Clade_6;Phytophthora_megasperma
Phytophthora_megasperma_P6957	Heterokontophyta;Oomycetes;Pythiales;Pythiaceae;Phytophthora;Phytophthora_Clade_6;Phytophthora_megasperma
Phytophthora_melonis_325917	Heterokontophyta;Oomycetes;Pythiales;Pythiaceae;Phytophthora;Phytophthora_Clade_7;Phytophthora_melonis
Phytophthora_melonis_CBS58269	Heterokontophyta;Oomycetes;Pythiales;Pythiaceae;Phytophthora;Phytophthora_Clade_7;Phytophthora_melonis
Phytophthora_melonis_P3609	Heterokontophyta;Oomycetes;Pythiales;Pythiaceae;Phytophthora;Phytophthora_Clade_7;Phytophthora_melonis
Phytophthora_melonis_P6870	Heterokontophyta;Oomycetes;Pythiales;Pythiaceae;Phytophthora;Phytophthora_Clade_7;Phytophthora_melonis
Phytophthora_mengei_P10139	Heterokontophyta;Oomycetes;Pythiales;Pythiaceae;Phytophthora;Phytophthora_Clade_2;Phytophthora_mengei
Phytophthora_mengei_P1275	Heterokontophyta;Oomycetes;Pythiales;Pythiaceae;Phytophthora;Phytophthora_Clade_2;Phytophthora_mengei
Phytophthora_mexicana_P0646	Heterokontophyta;Oomycetes;Pythiales;Pythiaceae;Phytophthora;Phytophthora_Clade_2;Phytophthora_mexicana
Phytophthora_mirabilis_CBS122204	Heterokontophyta;Oomycetes;Pythiales;Pythiaceae;Phytophthora;Phytophthora_Clade_1;Phytophthora_mirabilis
Phytophthora_mirabilis_CBS67885	Heterokontophyta;Oomycetes;Pythiales;Pythiaceae;Phytophthora;Phytophthora_Clade_1;Phytophthora_mirabilis
Phytophthora_mirabilis_P10231	Heterokontophyta;Oomycetes;Pythiales;Pythiaceae;Phytophthora;Phytophthora_Clade_1;Phytophthora_mirabilis
Phytophthora_mirabilis_P3005	Heterokontophyta;Oomycetes;Pythiales;Pythiaceae;Phytophthora;Phytophthora_Clade_1;Phytophthora_mirabilis
Phytophthora_mirabilis_p3006	Heterokontophyta;Oomycetes;Pythiales;Pythiaceae;Phytophthora;Phytophthora_Clade_1;Phytophthora_mirabilis
Phytophthora_mirabilis_P3010	Heterokontophyta;Oomycetes;Pythiales;Pythiaceae;Phytophthora;Phytophthora_Clade_1;Phytophthora_mirabilis
Phytophthora_multivesiculata_CBS54596	Heterokontophyta;Oomycetes;Pythiales;Pythiaceae;Phytophthora;Phytophthora_Clade_2;Phytophthora_multivesiculata
Phytophthora_multivesiculata_IMI386053	Heterokontophyta;Oomycetes;Pythiales;Pythiaceae;Phytophthora;Phytophthora_Clade_2;Phytophthora_multivesiculata
Phytophthora_multivesiculata_P10670	Heterokontophyta;Oomycetes;Pythiales;Pythiaceae;Phytophthora;Phytophthora_Clade_2;Phytophthora_multivesiculata
Phytophthora_multivora_BR514	Heterokontophyta;Oomycetes;Pythiales;Pythiaceae;Phytophthora;Phytophthora_Clade_2;Phytophthora_multivora
Phytophthora_multivora_CBS111337	Heterokontophyta;Oomycetes;Pythiales;Pythiaceae;Phytophthora;Phytophthora_Clade_2;Phytophthora_multivora
Phytophthora_multivora_CBS113347	Heterokontophyta;Oomycetes;Pythiales;Pythiaceae;Phytophthora;Phytophthora_Clade_2;Phytophthora_multivora
Phytophthora_multivora_CBS119108	Heterokontophyta;Oomycetes;Pythiales;Pythiaceae;Phytophthora;Phytophthora_Clade_2;Phytophthora_multivora
Phytophthora_multivora_P1233	Heterokontophyta;Oomycetes;Pythiales;Pythiaceae;Phytophthora;Phytophthora_Clade_2;Phytophthora_multivora
Phytophthora_nemorosa_CBS114870	Heterokontophyta;Oomycetes;Pythiales;Pythiaceae;Phytophthora;Phytophthora_Clade_3;Phytophthora_nemorosa
Phytophthora_nemorosa_P10288	Heterokontophyta;Oomycetes;Pythiales;Pythiaceae;Phytophthora;Phytophthora_Clade_3;Phytophthora_nemorosa
Phytophthora_nemorosa_P16352	Heterokontophyta;Oomycetes;Pythiales;Pythiaceae;Phytophthora;Phytophthora_Clade_3;Phytophthora_nemorosa
Phytophthora_nemorosa_PRI708	Heterokontophyta;Oomycetes;Pythiales;Pythiaceae;Phytophthora;Phytophthora_Clade_3;Phytophthora_nemorosa
Phytophthora_nemorosa_PRI709	Heterokontophyta;Oomycetes;Pythiales;Pythiaceae;Phytophthora;Phytophthora_Clade_3;Phytophthora_nemorosa
Phytophthora_nemorosa_PRI710	Heterokontophyta;Oomycetes;Pythiales;Pythiaceae;Phytophthora;Phytophthora_Clade_3;Phytophthora_nemorosa
Phytophthora_nemorosa_PRI711	Heterokontophyta;Oomycetes;Pythiales;Pythiaceae;Phytophthora;Phytophthora_Clade_3;Phytophthora_nemorosa
Phytophthora_nicotianae_81	Heterokontophyta;Oomycetes;Pythiales;Pythiaceae;Phytophthora;Phytophthora_Clade_1;Phytophthora_nicotianae
Phytophthora_nicotianae_CBS101655	Heterokontophyta;Oomycetes;Pythiales;Pythiaceae;Phytophthora;Phytophthora_Clade_1;Phytophthora_nicotianae
Phytophthora_nicotianae_CBS30329	Heterokontophyta;Oomycetes;Pythiales;Pythiaceae;Phytophthora;Phytophthora_Clade_1;Phytophthora_nicotianae
Phytophthora_nicotianae_CBS30429	Heterokontophyta;Oomycetes;Pythiales;Pythiaceae;Phytophthora;Phytophthora_Clade_1;Phytophthora_nicotianae
Phytophthora_nicotianae_CBS31062	Heterokontophyta;Oomycetes;Pythiales;Pythiaceae;Phytophthora;Phytophthora_Clade_1;Phytophthora_nicotianae
Phytophthora_nicotianae_CBS53492	Heterokontophyta;Oomycetes;Pythiales;Pythiaceae;Phytophthora;Phytophthora_Clade_1;Phytophthora_nicotianae
Phytophthora_nicotianae_P10297	Heterokontophyta;Oomycetes;Pythiales;Pythiaceae;Phytophthora;Phytophthora_Clade_1;Phytophthora_nicotianae
Phytophthora_nicotianae_P10381	Heterokontophyta;Oomycetes;Pythiales;Pythiaceae;Phytophthora;Phytophthora_Clade_1;Phytophthora_nicotianae
Phytophthora_nicotianae_P6915	Heterokontophyta;Oomycetes;Pythiales;Pythiaceae;Phytophthora;Phytophthora_Clade_1;Phytophthora_nicotianae
Phytophthora_nicotianae_P7146	Heterokontophyta;Oomycetes;Pythiales;Pythiaceae;Phytophthora;Phytophthora_Clade_1;Phytophthora_nicotianae
Phytophthora_palmivora_CBS17926	Heterokontophyta;Oomycetes;Pythiales;Pythiaceae;Phytophthora;Phytophthora_Clade_4;Phytophthora_palmivora
Phytophthora_palmivora_CBS27433	Heterokontophyta;Oomycetes;Pythiales;Pythiaceae;Phytophthora;Phytophthora_Clade_4;Phytophthora_palmivora
Phytophthora_palmivora_CBS29829	Heterokontophyta;Oomycetes;Pythiales;Pythiaceae;Phytophthora;Phytophthora_Clade_4;Phytophthora_palmivora
Phytophthora_palmivora_CBS29929	Heterokontophyta;Oomycetes;Pythiales;Pythiaceae;Phytophthora;Phytophthora_Clade_4;Phytophthora_palmivora
Phytophthora_palmivora_P0113	Heterokontophyta;Oomycetes;Pythiales;Pythiaceae;Phytophthora;Phytophthora_Clade_4;Phytophthora_palmivora
Phytophthora_palmivora_P0255	Heterokontophyta;Oomycetes;Pythiales;Pythiaceae;Phytophthora;Phytophthora_Clade_4;Phytophthora_palmivora
Phytophthora_palmivora_P16385	Heterokontophyta;Oomycetes;Pythiales;Pythiaceae;Phytophthora;Phytophthora_Clade_4;Phytophthora_palmivora
Phytophthora_palmivora_P6390	Heterokontophyta;Oomycetes;Pythiales;Pythiaceae;Phytophthora;Phytophthora_Clade_4;Phytophthora_palmivora
Phytophthora_parsiana_P15164	Heterokontophyta;Oomycetes;Pythiales;Pythiaceae;Phytophthora;Phytophthora_Clade_9;Phytophthora_parsiana
Phytophthora_parsiana_P21281	Heterokontophyta;Oomycetes;Pythiales;Pythiaceae;Phytophthora;Phytophthora_Clade_9;Phytophthora_parsiana
Phytophthora_parsiana_P21282	Heterokontophyta;Oomycetes;Pythiales;Pythiaceae;Phytophthora;Phytophthora_Clade_9;Phytophthora_parsiana
Phytophthora_phaseoli_CBS55688	Heterokontophyta;Oomycetes;Pythiales;Pythiaceae;Phytophthora;Phytophthora_Clade_1;Phytophthora_phaseoli
Phytophthora_phaseoli_P10145	Heterokontophyta;Oomycetes;Pythiales;Pythiaceae;Phytophthora;Phytophthora_Clade_1;Phytophthora_phaseoli
Phytophthora_phaseoli_P10150	Heterokontophyta;Oomycetes;Pythiales;Pythiaceae;Phytophthora;Phytophthora_Clade_1;Phytophthora_phaseoli
Phytophthora_phaseoli_P6609	Heterokontophyta;Oomycetes;Pythiales;Pythiaceae;Phytophthora;Phytophthora_Clade_1;Phytophthora_phaseoli
Phytophthora_pinifolia_P16100	Heterokontophyta;Oomycetes;Pythiales;Pythiaceae;Phytophthora;Phytophthora_Clade_6;Phytophthora_pinifolia
Phytophthora_pini_CBS18125	Heterokontophyta;Oomycetes;Pythiales;Pythiaceae;Phytophthora;Phytophthora_Clade_2;Phytophthora_pini
Phytophthora_pistaciae_P6196	Heterokontophyta;Oomycetes;Pythiales;Pythiaceae;Phytophthora;Phytophthora_Clade_7;Phytophthora_pistaciae
Phytophthora_pistaciae_P6197	Heterokontophyta;Oomycetes;Pythiales;Pythiaceae;Phytophthora;Phytophthora_Clade_7;Phytophthora_pistaciae
Phytophthora_plurivora_CBS117378	Heterokontophyta;Oomycetes;Pythiales;Pythiaceae;Phytophthora;Phytophthora_Clade_2;Phytophthora_plurivora
Phytophthora_plurivora_CBS37961	Heterokontophyta;Oomycetes;Pythiales;Pythiaceae;Phytophthora;Phytophthora_Clade_2;Phytophthora_plurivora
Phytophthora_polonica_P15004	Heterokontophyta;Oomycetes;Pythiales;Pythiaceae;Phytophthora;Phytophthora_Clade_9;Phytophthora_polonica
Phytophthora_polonica_P15005	Heterokontophyta;Oomycetes;Pythiales;Pythiaceae;Phytophthora;Phytophthora_Clade_9;Phytophthora_polonica
Phytophthora_polymorphica_CBS68084	Heterokontophyta;Oomycetes;Pythiales;Pythiaceae;Phytophthora;Halophytophthora;Phytophthora_polymorphica
Phytophthora_porri_CBS114100	Heterokontophyta;Oomycetes;Pythiales;Pythiaceae;Phytophthora;Phytophthora_Clade_8;Phytophthora_porri
Phytophthora_porri_CBS116662	Heterokontophyta;Oomycetes;Pythiales;Pythiaceae;Phytophthora;Phytophthora_Clade_8;Phytophthora_porri
Phytophthora_porri_CBS14187	Heterokontophyta;Oomycetes;Pythiales;Pythiaceae;Phytophthora;Phytophthora_Clade_8;Phytophthora_porri
Phytophthora_porri_CBS14287	Heterokontophyta;Oomycetes;Pythiales;Pythiaceae;Phytophthora;Phytophthora_Clade_8;Phytophthora_porri
Phytophthora_porri_CBS18187	Heterokontophyta;Oomycetes;Pythiales;Pythiaceae;Phytophthora;Phytophthora_Clade_8;Phytophthora_porri
Phytophthora_porri_CBS56786	Heterokontophyta;Oomycetes;Pythiales;Pythiaceae;Phytophthora;Phytophthora_Clade_8;Phytophthora_porri
Phytophthora_porri_CBS78397	Heterokontophyta;Oomycetes;Pythiales;Pythiaceae;Phytophthora;Phytophthora_Clade_8;Phytophthora_porri
Phytophthora_porri_P7518	Heterokontophyta;Oomycetes;Pythiales;Pythiaceae;Phytophthora;Phytophthora_Clade_8;Phytophthora_porri
Phytophthora_porri_P7899	Heterokontophyta;Oomycetes;Pythiales;Pythiaceae;Phytophthora;Phytophthora_Clade_8;Phytophthora_porri
Phytophthora_primulae_CBS100531	Heterokontophyta;Oomycetes;Pythiales;Pythiaceae;Phytophthora;Phytophthora_Clade_8;Phytophthora_primulae
Phytophthora_primulae_CBS110162	Heterokontophyta;Oomycetes;Pythiales;Pythiaceae;Phytophthora;Phytophthora_Clade_8;Phytophthora_primulae
Phytophthora_primulae_CBS110167	Heterokontophyta;Oomycetes;Pythiales;Pythiaceae;Phytophthora;Phytophthora_Clade_8;Phytophthora_primulae
Phytophthora_primulae_CBS62097	Heterokontophyta;Oomycetes;Pythiales;Pythiaceae;Phytophthora;Phytophthora_Clade_8;Phytophthora_primulae
Phytophthora_primulae_P10220	Heterokontophyta;Oomycetes;Pythiales;Pythiaceae;Phytophthora;Phytophthora_Clade_8;Phytophthora_primulae
Phytophthora_primulae_P10333	Heterokontophyta;Oomycetes;Pythiales;Pythiaceae;Phytophthora;Phytophthora_Clade_8;Phytophthora_primulae
Phytophthora_pseudosyringae_391716	Heterokontophyta;Oomycetes;Pythiales;Pythiaceae;Phytophthora;Phytophthora_Clade_3;Phytophthora_pseudosyringae
Phytophthora_pseudosyringae_CBS111773	Heterokontophyta;Oomycetes;Pythiales;Pythiaceae;Phytophthora;Phytophthora_Clade_3;Phytophthora_pseudosyringae
Phytophthora_pseudosyringae_CBS111774	Heterokontophyta;Oomycetes;Pythiales;Pythiaceae;Phytophthora;Phytophthora_Clade_3;Phytophthora_pseudosyringae
Phytophthora_pseudosyringae_CBS111775	Heterokontophyta;Oomycetes;Pythiales;Pythiaceae;Phytophthora;Phytophthora_Clade_3;Phytophthora_pseudosyringae
Phytophthora_pseudosyringae_CBS114108	Heterokontophyta;Oomycetes;Pythiales;Pythiaceae;Phytophthora;Phytophthora_Clade_3;Phytophthora_pseudosyringae
Phytophthora_pseudosyringae_P10443	Heterokontophyta;Oomycetes;Pythiales;Pythiaceae;Phytophthora;Phytophthora_Clade_3;Phytophthora_pseudosyringae
Phytophthora_pseudosyringae_P16355	Heterokontophyta;Oomycetes;Pythiales;Pythiaceae;Phytophthora;Phytophthora_Clade_3;Phytophthora_pseudosyringae
Phytophthora_pseudotsugae_331663	Heterokontophyta;Oomycetes;Pythiales;Pythiaceae;Phytophthora;Phytophthora_Clade_1;Phytophthora_pseudotsugae
Phytophthora_pseudotsugae_CBS44484	Heterokontophyta;Oomycetes;Pythiales;Pythiaceae;Phytophthora;Phytophthora_Clade_1;Phytophthora_pseudotsugae
Phytophthora_pseudotsugae_CBS44584	Heterokontophyta;Oomycetes;Pythiales;Pythiaceae;Phytophthora;Phytophthora_Clade_1;Phytophthora_pseudotsugae
Phytophthora_pseudotsugae_CBS44684	Heterokontophyta;Oomycetes;Pythiales;Pythiaceae;Phytophthora;Phytophthora_Clade_1;Phytophthora_pseudotsugae
Phytophthora_pseudotsugae_P10218	Heterokontophyta;Oomycetes;Pythiales;Pythiaceae;Phytophthora;Phytophthora_Clade_1;Phytophthora_pseudotsugae
Phytophthora_pseudotsugae_P10339	Heterokontophyta;Oomycetes;Pythiales;Pythiaceae;Phytophthora;Phytophthora_Clade_1;Phytophthora_pseudotsugae
Phytophthora_psychrophila_P10433	Heterokontophyta;Oomycetes;Pythiales;Pythiaceae;Phytophthora;Phytophthora_Clade_3;Phytophthora_psychrophila
Phytophthora_quercetorum_P15555	Heterokontophyta;Oomycetes;Pythiales;Pythiaceae;Phytophthora;Phytophthora_Clade_4;Phytophthora_quercetorum
Phytophthora_quercina_CBS78195	Heterokontophyta;Oomycetes;Pythiales;Pythiaceae;Phytophthora;Phytophthora_Clade_4;Phytophthora_quercina
Phytophthora_quercina_CBS78695	Heterokontophyta;Oomycetes;Pythiales;Pythiaceae;Phytophthora;Phytophthora_Clade_4;Phytophthora_quercina
Phytophthora_quercina_CBS78795	Heterokontophyta;Oomycetes;Pythiales;Pythiaceae;Phytophthora;Phytophthora_Clade_4;Phytophthora_quercina
Phytophthora_quercina_CBS78895	Heterokontophyta;Oomycetes;Pythiales;Pythiaceae;Phytophthora;Phytophthora_Clade_4;Phytophthora_quercina
Phytophthora_quercina_P10334	Heterokontophyta;Oomycetes;Pythiales;Pythiaceae;Phytophthora;Phytophthora_Clade_4;Phytophthora_quercina
Phytophthora_quercina_P10441	Heterokontophyta;Oomycetes;Pythiales;Pythiaceae;Phytophthora;Phytophthora_Clade_4;Phytophthora_quercina
Phytophthora_quininea_CBS40748	Heterokontophyta;Oomycetes;Pythiales;Pythiaceae;Phytophthora;Phytophthora_Clade_9;Phytophthora_quininea
Phytophthora_quininea_P3247	Heterokontophyta;Oomycetes;Pythiales;Pythiaceae;Phytophthora;Phytophthora_Clade_9;Phytophthora_quininea
Phytophthora_quininea_P8488	Heterokontophyta;Oomycetes;Pythiales;Pythiaceae;Phytophthora;Phytophthora_Clade_9;Phytophthora_quininea
Phytophthora_ramorum_CBS101553	Heterokontophyta;Oomycetes;Pythiales;Pythiaceae;Phytophthora;Phytophthora_Clade_8;Phytophthora_ramorum
Phytophthora_ramorum_P10102	Heterokontophyta;Oomycetes;Pythiales;Pythiaceae;Phytophthora;Phytophthora_Clade_8;Phytophthora_ramorum
Phytophthora_ramorum_P10301	Heterokontophyta;Oomycetes;Pythiales;Pythiaceae;Phytophthora;Phytophthora_Clade_8;Phytophthora_ramorum
Phytophthora_sp_P6875	Heterokontophyta;Oomycetes;Pythiales;Pythiaceae;Phytophthora;Phytophthora;Phytophthora_sp
Phytophthora_rosacearum_P3159	Heterokontophyta;Oomycetes;Pythiales;Pythiaceae;Phytophthora;Phytophthora_Clade_6;Phytophthora_rosacearum
Phytophthora_rubi_CBS109892	Heterokontophyta;Oomycetes;Pythiales;Pythiaceae;Phytophthora;Phytophthora_Clade_7;Phytophthora_rubi
Phytophthora_rubi_CBS96795	Heterokontophyta;Oomycetes;Pythiales;Pythiaceae;Phytophthora;Phytophthora_Clade_7;Phytophthora_rubi
Phytophthora_rubi_P3289	Heterokontophyta;Oomycetes;Pythiales;Pythiaceae;Phytophthora;Phytophthora_Clade_7;Phytophthora_rubi
Phytophthora_rubi_P3316	Heterokontophyta;Oomycetes;Pythiales;Pythiaceae;Phytophthora;Phytophthora_Clade_7;Phytophthora_rubi
Phytophthora_sansomeana_BR1058	Heterokontophyta;Oomycetes;Pythiales;Pythiaceae;Phytophthora;Phytophthora_Clade_8;Phytophthora_sansomeana
Phytophthora_sansomeana_BR623	Heterokontophyta;Oomycetes;Pythiales;Pythiaceae;Phytophthora;Phytophthora_Clade_8;Phytophthora_sansomeana
Phytophthora_sansomeana_CBS95787	Heterokontophyta;Oomycetes;Pythiales;Pythiaceae;Phytophthora;Phytophthora_Clade_8;Phytophthora_sansomeana
Phytophthora_sansomeana_P3163	Heterokontophyta;Oomycetes;Pythiales;Pythiaceae;Phytophthora;Phytophthora_Clade_8;Phytophthora_sansomeana
Phytophthora_sansomeana_P8048	Heterokontophyta;Oomycetes;Pythiales;Pythiaceae;Phytophthora;Phytophthora_Clade_8;Phytophthora_sansomeana
Phytophthora_sansomeana_P8049	Heterokontophyta;Oomycetes;Pythiales;Pythiaceae;Phytophthora;Phytophthora_Clade_8;Phytophthora_sansomeana
Phytophthora_sinensis_CBS55788	Heterokontophyta;Oomycetes;Pythiales;Pythiaceae;Phytophthora;Phytophthora_Clade_7;Phytophthora_sinensis
Phytophthora_sinensis_P1475	Heterokontophyta;Oomycetes;Pythiales;Pythiaceae;Phytophthora;Phytophthora_Clade_7;Phytophthora_sinensis
Phytophthora_sinensis_P1748	Heterokontophyta;Oomycetes;Pythiales;Pythiaceae;Phytophthora;Phytophthora_Clade_7;Phytophthora_sinensis
Phytophthora_siskiyouensis_P15122	Heterokontophyta;Oomycetes;Pythiales;Pythiaceae;Phytophthora;Phytophthora_Clade_2;Phytophthora_siskiyouensis
Phytophthora_siskiyouensis_P15123	Heterokontophyta;Oomycetes;Pythiales;Pythiaceae;Phytophthora;Phytophthora_Clade_2;Phytophthora_siskiyouensis
Phytophthora_siskiyouensis_P16301	Heterokontophyta;Oomycetes;Pythiales;Pythiaceae;Phytophthora;Phytophthora_Clade_2;Phytophthora_siskiyouensis
Phytophthora_siskiyouensis_PRI816	Heterokontophyta;Oomycetes;Pythiales;Pythiaceae;Phytophthora;Phytophthora_Clade_2;Phytophthora_siskiyouensis
Phytophthora_siskiyouensis_PRI817	Heterokontophyta;Oomycetes;Pythiales;Pythiaceae;Phytophthora;Phytophthora_Clade_2;Phytophthora_siskiyouensis
Phytophthora_sojae_BR1079	Heterokontophyta;Oomycetes;Pythiales;Pythiaceae;Phytophthora;Phytophthora_Clade_7;Phytophthora_sojae
Phytophthora_sojae_BR582	Heterokontophyta;Oomycetes;Pythiales;Pythiaceae;Phytophthora;Phytophthora_Clade_7;Phytophthora_sojae
Phytophthora_sojae_CBS38261	Heterokontophyta;Oomycetes;Pythiales;Pythiaceae;Phytophthora;Phytophthora_Clade_7;Phytophthora_sojae
Phytophthora_sojae_P0405	Heterokontophyta;Oomycetes;Pythiales;Pythiaceae;Phytophthora;Phytophthora_Clade_7;Phytophthora_sojae
Phytophthora_sojae_P10704	Heterokontophyta;Oomycetes;Pythiales;Pythiaceae;Phytophthora;Phytophthora_Clade_7;Phytophthora_sojae
Phytophthora_sojae_P3114	Heterokontophyta;Oomycetes;Pythiales;Pythiaceae;Phytophthora;Phytophthora_Clade_7;Phytophthora_sojae
Phytophthora_sojae_P6497	Heterokontophyta;Oomycetes;Pythiales;Pythiaceae;Phytophthora;Phytophthora_Clade_7;Phytophthora_sojae
Phytophthora_sojae_P7061	Heterokontophyta;Oomycetes;Pythiales;Pythiaceae;Phytophthora;Phytophthora_Clade_7;Phytophthora_sojae
Phytophthora_sp_andina_EC3163	Heterokontophyta;Oomycetes;Pythiales;Pythiaceae;Phytophthora;Phytophthora_Clade_1;Phytophthora_sp_andina
Phytophthora_aff_infestans_P13660	Heterokontophyta;Oomycetes;Pythiales;Pythiaceae;Phytophthora;Phytophthora_Clade_1;Phytophthora_aff_infestans
Phytophthora_sp_andina_PRI814	Heterokontophyta;Oomycetes;Pythiales;Pythiaceae;Phytophthora;Phytophthora_Clade_1;Phytophthora_sp_andina
Phytophthora_sp_asparagi_P10690	Heterokontophyta;Oomycetes;Pythiales;Pythiaceae;Phytophthora;Phytophthora_Clade_6;Phytophthora_sp_asparagi
Phytophthora_sp_asparagi_P10693	Heterokontophyta;Oomycetes;Pythiales;Pythiaceae;Phytophthora;Phytophthora_Clade_6;Phytophthora_sp_asparagi
Phytophthora_sp_asparagi_P10707	Heterokontophyta;Oomycetes;Pythiales;Pythiaceae;Phytophthora;Phytophthora_Clade_6;Phytophthora_sp_asparagi
Phytophthora_sp_canalensis_P10456	Heterokontophyta;Oomycetes;Pythiales;Pythiaceae;Phytophthora;Phytophthora_Clade_6;Phytophthora_sp_canalensis
Phytophthora_sp_cuyabensis_P8213	Heterokontophyta;Oomycetes;Pythiales;Pythiaceae;Phytophthora;Phytophthora_Clade_9;Phytophthora_sp_cuyabensis
Phytophthora_sp_cuyabensis_P8218	Heterokontophyta;Oomycetes;Pythiales;Pythiaceae;Phytophthora;Phytophthora_Clade_9;Phytophthora_sp_cuyabensis
Phytophthora_sp_cuyabensis_P8230	Heterokontophyta;Oomycetes;Pythiales;Pythiaceae;Phytophthora;Phytophthora_Clade_9;Phytophthora_sp_cuyabensis
Phytophthora_sp_cuyabensis_P8232	Heterokontophyta;Oomycetes;Pythiales;Pythiaceae;Phytophthora;Phytophthora_Clade_9;Phytophthora_sp_cuyabensis
Phytophthora_sp_glovera_P10618	Heterokontophyta;Oomycetes;Pythiales;Pythiaceae;Phytophthora;Phytophthora_Clade_2;Phytophthora_sp_glovera
Phytophthora_sp_glovera_P10619	Heterokontophyta;Oomycetes;Pythiales;Pythiaceae;Phytophthora;Phytophthora_Clade_2;Phytophthora_sp_glovera
Phytophthora_sp_kelmania_CBS30762	Heterokontophyta;Oomycetes;Pythiales;Pythiaceae;Phytophthora;Phytophthora_Clade_8;Phytophthora_sp_kelmania
Phytophthora_sp_kelmania_P10613	Heterokontophyta;Oomycetes;Pythiales;Pythiaceae;Phytophthora;Phytophthora_Clade_8;Phytophthora_sp_kelmania
Phytophthora_sp_kelmania_P10614	Heterokontophyta;Oomycetes;Pythiales;Pythiaceae;Phytophthora;Phytophthora_Clade_8;Phytophthora_sp_kelmania
Phytophthora_sp_lacrimae_P15880	Heterokontophyta;Oomycetes;Pythiales;Pythiaceae;Phytophthora;Phytophthora_Clade_6;Phytophthora_sp_lacrimae
Phytophthora_sp_lagoariana_P8220	Heterokontophyta;Oomycetes;Pythiales;Pythiaceae;Phytophthora;Phytophthora_Clade_9;Phytophthora_sp_lagoariana
Phytophthora_sp_lagoariana_P8223	Heterokontophyta;Oomycetes;Pythiales;Pythiaceae;Phytophthora;Phytophthora_Clade_9;Phytophthora_sp_lagoariana
Phytophthora_sp_napoensis_P8221	Heterokontophyta;Oomycetes;Pythiales;Pythiaceae;Phytophthora;Phytophthora_Clade_9;Phytophthora_sp_napoensis
Phytophthora_sp_napoensis_P8225	Heterokontophyta;Oomycetes;Pythiales;Pythiaceae;Phytophthora;Phytophthora_Clade_9;Phytophthora_sp_napoensis
Phytophthora_sp_napoensis_P8233	Heterokontophyta;Oomycetes;Pythiales;Pythiaceae;Phytophthora;Phytophthora_Clade_9;Phytophthora_sp_napoensis
Phytophthora_sp_niederhauserii_P10279	Heterokontophyta;Oomycetes;Pythiales;Pythiaceae;Phytophthora;Phytophthora_Clade_7;Phytophthora_sp_niederhauserii
Phytophthora_sp_niederhauserii_P10616	Heterokontophyta;Oomycetes;Pythiales;Pythiaceae;Phytophthora;Phytophthora_Clade_7;Phytophthora_sp_niederhauserii
Phytophthora_sp_niederhauserii_P10617	Heterokontophyta;Oomycetes;Pythiales;Pythiaceae;Phytophthora;Phytophthora_Clade_7;Phytophthora_sp_niederhauserii
Phytophthora_sp_niederhauserii_P10976	Heterokontophyta;Oomycetes;Pythiales;Pythiaceae;Phytophthora;Phytophthora_Clade_7;Phytophthora_sp_niederhauserii
Phytophthora_sp_niederhauserii_P16237	Heterokontophyta;Oomycetes;Pythiales;Pythiaceae;Phytophthora;Phytophthora_Clade_7;Phytophthora_sp_niederhauserii
Phytophthora_sp_novaeguinea_P1256	Heterokontophyta;Oomycetes;Pythiales;Pythiaceae;Phytophthora;Phytophthora_Clade_5;Phytophthora_sp_novaeguinea
Phytophthora_sp_ohioensis_P16050	Heterokontophyta;Oomycetes;Pythiales;Pythiaceae;Phytophthora;Phytophthora_Clade_4;Phytophthora_sp_ohioensis
Phytophthora_sp_sulawesiensis_P6306	Heterokontophyta;Oomycetes;Pythiales;Pythiaceae;Phytophthora;Phytophthora_Clade_6;Phytophthora_sp_sulawesiensis
Phytophthora_sp_thermophilum_P10457	Heterokontophyta;Oomycetes;Pythiales;Pythiaceae;Phytophthora;Phytophthora_Clade_9;Phytophthora_sp_thermophilum
Phytophthora_sp_thermophilum_P1896	Heterokontophyta;Oomycetes;Pythiales;Pythiaceae;Phytophthora;Phytophthora_Clade_9;Phytophthora_sp_thermophilum
Phytophthora_sp_nov_BR333	Heterokontophyta;Oomycetes;Pythiales;Pythiaceae;Phytophthora;Phytophthora_sp_nov;Phytophthora_sp_nov
Phytophthora_sp_nov_CBS111346	Heterokontophyta;Oomycetes;Pythiales;Pythiaceae;Phytophthora;Phytophthora_sp_nov;Phytophthora_sp_nov
Phytophthora_sp_nov_CBS114338	Heterokontophyta;Oomycetes;Pythiales;Pythiaceae;Phytophthora;Phytophthora_sp_nov;Phytophthora_sp_nov
Phytophthora_sp_nov_CBS36879	Heterokontophyta;Oomycetes;Pythiales;Pythiaceae;Phytophthora;Phytophthora_sp_nov;Phytophthora_sp_nov
Phytophthora_sp_nov_P10337	Heterokontophyta;Oomycetes;Pythiales;Pythiaceae;Phytophthora;Phytophthora_sp_nov;Phytophthora_sp_nov
Phytophthora_sp_nov_P10728	Heterokontophyta;Oomycetes;Pythiales;Pythiaceae;Phytophthora;Phytophthora_sp_nov;Phytophthora_sp_nov
Phytophthora_sp_nov_P1212	Heterokontophyta;Oomycetes;Pythiales;Pythiaceae;Phytophthora;Phytophthora_sp_nov;Phytophthora_sp_nov
Phytophthora_sp_nov_P3600	Heterokontophyta;Oomycetes;Pythiales;Pythiaceae;Phytophthora;Phytophthora_sp_nov;Phytophthora_sp_nov
Phytophthora_sp_nov_P6207	Heterokontophyta;Oomycetes;Pythiales;Pythiaceae;Phytophthora;Phytophthora_sp_nov;Phytophthora_sp_nov
Phytophthora_syringae_CBS110161	Heterokontophyta;Oomycetes;Pythiales;Pythiaceae;Phytophthora;Phytophthora_Clade_8;Phytophthora_syringae
Phytophthora_syringae_CBS114107	Heterokontophyta;Oomycetes;Pythiales;Pythiaceae;Phytophthora;Phytophthora_Clade_8;Phytophthora_syringae
Phytophthora_syringae_CBS114109	Heterokontophyta;Oomycetes;Pythiales;Pythiaceae;Phytophthora;Phytophthora_Clade_8;Phytophthora_syringae
Phytophthora_syringae_CBS114110	Heterokontophyta;Oomycetes;Pythiales;Pythiaceae;Phytophthora;Phytophthora_Clade_8;Phytophthora_syringae
Phytophthora_syringae_CBS13223	Heterokontophyta;Oomycetes;Pythiales;Pythiaceae;Phytophthora;Phytophthora_Clade_8;Phytophthora_syringae
Phytophthora_syringae_CBS27574	Heterokontophyta;Oomycetes;Pythiales;Pythiaceae;Phytophthora;Phytophthora_Clade_8;Phytophthora_syringae
Phytophthora_syringae_CBS36452	Heterokontophyta;Oomycetes;Pythiales;Pythiaceae;Phytophthora;Phytophthora_Clade_8;Phytophthora_syringae
Phytophthora_syringae_P10330	Heterokontophyta;Oomycetes;Pythiales;Pythiaceae;Phytophthora;Phytophthora_Clade_8;Phytophthora_syringae
Phytophthora_syringae_P10332	Heterokontophyta;Oomycetes;Pythiales;Pythiaceae;Phytophthora;Phytophthora_Clade_8;Phytophthora_syringae
Phytophthora_syringae_P2004	Heterokontophyta;Oomycetes;Pythiales;Pythiaceae;Phytophthora;Phytophthora_Clade_8;Phytophthora_syringae
Phytophthora_tabaci_CBS30529	Heterokontophyta;Oomycetes;Pythiales;Pythiaceae;Phytophthora;Phytophthora_Clade_1;Phytophthora_tabaci
Phytophthora_tentaculata_CBS100411	Heterokontophyta;Oomycetes;Pythiales;Pythiaceae;Phytophthora;Phytophthora_Clade_1;Phytophthora_tentaculata
Phytophthora_tentaculata_CBS115458	Heterokontophyta;Oomycetes;Pythiales;Pythiaceae;Phytophthora;Phytophthora_Clade_1;Phytophthora_tentaculata
Phytophthora_tentaculata_CBS41296	Heterokontophyta;Oomycetes;Pythiales;Pythiaceae;Phytophthora;Phytophthora_Clade_1;Phytophthora_tentaculata
Phytophthora_tentaculata_CBS55296	Heterokontophyta;Oomycetes;Pythiales;Pythiaceae;Phytophthora;Phytophthora_Clade_1;Phytophthora_tentaculata
Phytophthora_tentaculata_P10363	Heterokontophyta;Oomycetes;Pythiales;Pythiaceae;Phytophthora;Phytophthora_Clade_1;Phytophthora_tentaculata
Phytophthora_tentaculata_P8497	Heterokontophyta;Oomycetes;Pythiales;Pythiaceae;Phytophthora;Phytophthora_Clade_1;Phytophthora_tentaculata
Phytophthora_trifolii_CBS117688	Heterokontophyta;Oomycetes;Pythiales;Pythiaceae;Phytophthora;Phytophthora_Clade_8;Phytophthora_trifolii
Phytophthora_trifolii_P1462	Heterokontophyta;Oomycetes;Pythiales;Pythiaceae;Phytophthora;Phytophthora_Clade_8;Phytophthora_trifolii
Phytophthora_tropicalis_CBS43491	Heterokontophyta;Oomycetes;Pythiales;Pythiaceae;Phytophthora;Phytophthora_Clade_2;Phytophthora_tropicalis
Phytophthora_tropicalis_p27	Heterokontophyta;Oomycetes;Pythiales;Pythiaceae;Phytophthora;Phytophthora_Clade_2;Phytophthora_tropicalis
Phytophthora_tropicalis_P6522	Heterokontophyta;Oomycetes;Pythiales;Pythiaceae;Phytophthora;Phytophthora_Clade_2;Phytophthora_tropicalis
Phytophthora_uliginosa_P10328	Heterokontophyta;Oomycetes;Pythiales;Pythiaceae;Phytophthora;Phytophthora_Clade_7;Phytophthora_uliginosa
Phytophthora_uliginosa_P10413	Heterokontophyta;Oomycetes;Pythiales;Pythiaceae;Phytophthora;Phytophthora_Clade_7;Phytophthora_uliginosa
Phytophthora_vignae_P3019	Heterokontophyta;Oomycetes;Pythiales;Pythiaceae;Phytophthora;Phytophthora_Clade_7;Phytophthora_vignae
Phytophthora_vignae_P7471	Heterokontophyta;Oomycetes;Pythiales;Pythiaceae;Phytophthora;Phytophthora_Clade_7;Phytophthora_vignae
Plasmoverna_anemones_ranunculoidis_HV125	Heterokontophyta;Oomycetes;Peronosporales;Peronosporaceae;Plasmoverna;Plasmoverna;Plasmoverna_anemones_ranunculoidis
Plasmopara_euphrasiae_HV2226	Heterokontophyta;Oomycetes;Peronosporales;Peronosporaceae;Plasmopara;Plasmopara;Plasmopara_euphrasiae
Plasmopara_nivea_HV75	Heterokontophyta;Oomycetes;Peronosporales;Peronosporaceae;Plasmopara;Plasmopara;Plasmopara_nivea
Plasmopara_pusilla_HV140	Heterokontophyta;Oomycetes;Peronosporales;Peronosporaceae;Plasmopara;Plasmopara;Plasmopara_pusilla
Plectospira_myriandra_CBS52387	Heterokontophyta;Oomycetes;Saprolegniales;Saprolegniaceae;Plectospira;Plectospira;Plectospira_myriandra
Protoachlya_paradoxa_CBS10044	Heterokontophyta;Oomycetes;Saprolegniales;Saprolegniaceae;Protoachlya;Protoachlya;Protoachlya_paradoxa
Protoachlya_paradoxa_CBS15845	Heterokontophyta;Oomycetes;Saprolegniales;Saprolegniaceae;Protoachlya;Protoachlya;Protoachlya_paradoxa
Pseudoperonospora_cubensis_HV222	Heterokontophyta;Oomycetes;Peronosporales;Peronosporaceae;Pseudoperonospora;Pseudoperonospora;Pseudoperonospora_cubensis
Pythiogeton_zeae_Lev3132	Heterokontophyta;Oomycetes;Pythiales;Pythiogetonaceae;Pythiogeton;Pythiogeton;Pythiogeton_zeae
Pythiopsis_terrestris_CBS110058	Heterokontophyta;Oomycetes;Saprolegniales;Saprolegniaceae;Pythiopsis;Pythiopsis;Pythiopsis_terrestris
Pythiopsis_terrestris_CBS110059	Heterokontophyta;Oomycetes;Saprolegniales;Saprolegniaceae;Pythiopsis;Pythiopsis;Pythiopsis_terrestris
Pythium_abappressorium_CBS110198	Heterokontophyta;Oomycetes;Pythiales;Pythiaceae;Pythium;Pythium_Clade_F;Pythium_abappressorium
Pythium_acanthicum_BR228	Heterokontophyta;Oomycetes;Pythiales;Pythiaceae;Pythium;Pythium_Clade_D;Pythium_acanthicum
Pythium_acanthicum_BR500	Heterokontophyta;Oomycetes;Pythiales;Pythiaceae;Pythium;Pythium_Clade_D;Pythium_acanthicum
Pythium_acanthicum_CBS37734	Heterokontophyta;Oomycetes;Pythiales;Pythiaceae;Pythium;Pythium_Clade_D;Pythium_acanthicum
Pythium_acanthicum_Lev1618	Heterokontophyta;Oomycetes;Pythiales;Pythiaceae;Pythium;Pythium_Clade_D;Pythium_acanthicum
Pythium_acanthophoron_CBS33729	Heterokontophyta;Oomycetes;Pythiales;Pythiaceae;Pythium;Pythium_Clade_J;Pythium_acanthophoron
Pythium_acrogynum_CBS54988	Heterokontophyta;Oomycetes;Pythiales;Pythiaceae;Pythium;Pythium_Clade_E;Pythium_acrogynum
Pythium_adhaerens_CBS52074	Heterokontophyta;Oomycetes;Pythiales;Pythiaceae;Pythium;Pythium_Clade_B;Pythium_adhaerens
Pythium_afertile_Lev2066	Heterokontophyta;Oomycetes;Pythiales;Pythiaceae;Pythium;Pythium_Clade_B;Pythium_afertile
Pythium_aff_attrantheridium_Lev3004	Heterokontophyta;Oomycetes;Pythiales;Pythiaceae;Pythium;Pythium_Clade_F;Pythium_aff_attrantheridium
Pythium_aff_diclinum_CBS22994	Heterokontophyta;Oomycetes;Pythiales;Pythiaceae;Pythium;Pythium_Clade_B;Pythium_aff_diclinum
Pythium_aff_dictyosporum_ADC0113	Heterokontophyta;Oomycetes;Pythiales;Pythiaceae;Pythium;Pythium_Clade_B;Pythium_aff_dictyosporum
Pythium_aff_dictyosporum_ADC0116	Heterokontophyta;Oomycetes;Pythiales;Pythiaceae;Pythium;Pythium_Clade_B;Pythium_aff_dictyosporum
Pythium_aff_dissotocum_BR725	Heterokontophyta;Oomycetes;Pythiales;Pythiaceae;Pythium;Pythium_Clade_B;Pythium_aff_dissotocum
Pythium_aff_dissotocum_BR726	Heterokontophyta;Oomycetes;Pythiales;Pythiaceae;Pythium;Pythium_Clade_B;Pythium_aff_dissotocum
Pythium_aff_dissotocum_BR907	Heterokontophyta;Oomycetes;Pythiales;Pythiaceae;Pythium;Pythium_Clade_B;Pythium_aff_dissotocum
Pythium_aff_dissotocum_BR992	Heterokontophyta;Oomycetes;Pythiales;Pythiaceae;Pythium;Pythium_Clade_B;Pythium_aff_dissotocum
Pythium_aff_hydnosporum_BR978	Heterokontophyta;Oomycetes;Pythiales;Pythiaceae;Pythium;Pythium_Clade_D;Pythium_aff_hydnosporum
Pythium_aff_hypogynum_BR116	Heterokontophyta;Oomycetes;Pythiales;Pythiaceae;Pythium;Pythium_Clade_E;Pythium_aff_hypogynum
Pythium_aff_iwayamai_DAOM229147	Heterokontophyta;Oomycetes;Pythiales;Pythiaceae;Pythium;Pythium_Clade_G;Pythium_aff_iwayamai
Pythium_aff_macrosporum_BR1029	Heterokontophyta;Oomycetes;Pythiales;Pythiaceae;Pythium;Pythium_Clade_F;Pythium_aff_macrosporum
Pythium_aff_oopapillum_Lev1619	Heterokontophyta;Oomycetes;Pythiales;Pythiaceae;Pythium;Pythium_Clade_B;Pythium_aff_oopapillum
Pythium_aff_periilum_CBS23783	Heterokontophyta;Oomycetes;Pythiales;Pythiaceae;Pythium;Pythium_Clade_B;Pythium_aff_periilum
Pythium_aff_perplexum_BR925	Heterokontophyta;Oomycetes;Pythiales;Pythiaceae;Pythium;Pythium_Clade_J;Pythium_aff_perplexum
Pythium_aff_pleroticum_ADC9912	Heterokontophyta;Oomycetes;Pythiales;Pythiaceae;Pythium;Pythium_Clade_E;Pythium_aff_pleroticum
Pythium_aff_pleroticum_Lev2114	Heterokontophyta;Oomycetes;Pythiales;Pythiaceae;Pythium;Pythium_Clade_E;Pythium_aff_pleroticum
Pythium_aff_polymastum_ADC9817	Heterokontophyta;Oomycetes;Pythiales;Pythiaceae;Pythium;Pythium_Clade_J;Pythium_aff_polymastum
Pythium_aff_polymastum_Lev1630	Heterokontophyta;Oomycetes;Pythiales;Pythiaceae;Pythium;Pythium_Clade_J;Pythium_aff_polymastum
Pythium_aff_torulosum_BR626	Heterokontophyta;Oomycetes;Pythiales;Pythiaceae;Pythium;Pythium_Clade_B;Pythium_aff_torulosum
Pythium_aff_torulosum_BR780	Heterokontophyta;Oomycetes;Pythiales;Pythiaceae;Pythium;Pythium_Clade_B;Pythium_aff_torulosum
Pythium_aff_torulosum_BR897	Heterokontophyta;Oomycetes;Pythiales;Pythiaceae;Pythium;Pythium_Clade_B;Pythium_aff_torulosum
Pythium_aff_volutum_BR974	Heterokontophyta;Oomycetes;Pythiales;Pythiaceae;Pythium;Pythium_Clade_B;Pythium_aff_volutum
Pythium_aff_volutum_Lev1528	Heterokontophyta;Oomycetes;Pythiales;Pythiaceae;Pythium;Pythium_Clade_B;Pythium_aff_volutum
Pythium_amasculinum_CBS55288	Heterokontophyta;Oomycetes;Pythiales;Pythiaceae;Pythium;Pythium_Clade_D;Pythium_amasculinum
Pythium_anandrum_CBS28531	Heterokontophyta;Oomycetes;Pythiales;Pythiaceae;Pythium;Pythium_Clade_H;Pythium_anandrum
Pythium_anandrum_Lev2116	Heterokontophyta;Oomycetes;Pythiales;Pythiaceae;Pythium;Pythium_Clade_H;Pythium_anandrum
Pythium_angustatum_CBS52274	Heterokontophyta;Oomycetes;Pythiales;Pythiaceae;Pythium;Pythium_Clade_B;Pythium_angustatum
Pythium_aphanidermatum_CBS11880	Heterokontophyta;Oomycetes;Pythiales;Pythiaceae;Pythium;Pythium_Clade_A;Pythium_aphanidermatum
Pythium_aphanidermatum_CBS28779	Heterokontophyta;Oomycetes;Pythiales;Pythiaceae;Pythium;Pythium_Clade_A;Pythium_aphanidermatum
Pythium_aphanidermatum_Lev1800	Heterokontophyta;Oomycetes;Pythiales;Pythiaceae;Pythium;Pythium_Clade_A;Pythium_aphanidermatum
Pythium_aphanidermatum_Lev2150	Heterokontophyta;Oomycetes;Pythiales;Pythiaceae;Pythium;Pythium_Clade_A;Pythium_aphanidermatum
Pythium_aphanidermatum_Lev3014	Heterokontophyta;Oomycetes;Pythiales;Pythiaceae;Pythium;Pythium_Clade_A;Pythium_aphanidermatum
Pythium_apiculatum_CBS120945	Heterokontophyta;Oomycetes;Pythiales;Pythiaceae;Pythium;Pythium_Clade_E;Pythium_apiculatum
Pythium_apleroticum_CBS77281	Heterokontophyta;Oomycetes;Pythiales;Pythiaceae;Pythium;Pythium_Clade_B;Pythium_apleroticum
Pythium_aquatile_BR654	Heterokontophyta;Oomycetes;Pythiales;Pythiaceae;Pythium;Pythium_Clade_B;Pythium_aquatile
Pythium_aquatile_CBS21580	Heterokontophyta;Oomycetes;Pythiales;Pythiaceae;Pythium;Pythium_Clade_B;Pythium_aquatile
Pythium_aristosporum_BR166	Heterokontophyta;Oomycetes;Pythiales;Pythiaceae;Pythium;Pythium_Clade_B;Pythium_aristosporum
Pythium_aristosporum_CBS26338	Heterokontophyta;Oomycetes;Pythiales;Pythiaceae;Pythium;Pythium_Clade_B;Pythium_aristosporum
Pythium_arrhenomanes_BR1028	Heterokontophyta;Oomycetes;Pythiales;Pythiaceae;Pythium;Pythium_Clade_B;Pythium_arrhenomanes
Pythium_arrhenomanes_BR122	Heterokontophyta;Oomycetes;Pythiales;Pythiaceae;Pythium;Pythium_Clade_B;Pythium_arrhenomanes
Pythium_arrhenomanes_BR140	Heterokontophyta;Oomycetes;Pythiales;Pythiaceae;Pythium;Pythium_Clade_B;Pythium_arrhenomanes
Pythium_arrhenomanes_BR155	Heterokontophyta;Oomycetes;Pythiales;Pythiaceae;Pythium;Pythium_Clade_B;Pythium_arrhenomanes
Pythium_arrhenomanes_BR605	Heterokontophyta;Oomycetes;Pythiales;Pythiaceae;Pythium;Pythium_Clade_B;Pythium_arrhenomanes
Pythium_arrhenomanes_BR606	Heterokontophyta;Oomycetes;Pythiales;Pythiaceae;Pythium;Pythium_Clade_B;Pythium_arrhenomanes
Pythium_arrhenomanes_BR615	Heterokontophyta;Oomycetes;Pythiales;Pythiaceae;Pythium;Pythium_Clade_B;Pythium_arrhenomanes
Pythium_arrhenomanes_BR618	Heterokontophyta;Oomycetes;Pythiales;Pythiaceae;Pythium;Pythium_Clade_B;Pythium_arrhenomanes
Pythium_arrhenomanes_BR619	Heterokontophyta;Oomycetes;Pythiales;Pythiaceae;Pythium;Pythium_Clade_B;Pythium_arrhenomanes
Pythium_arrhenomanes_BR625	Heterokontophyta;Oomycetes;Pythiales;Pythiaceae;Pythium;Pythium_Clade_B;Pythium_arrhenomanes
Pythium_arrhenomanes_BR667	Heterokontophyta;Oomycetes;Pythiales;Pythiaceae;Pythium;Pythium_Clade_B;Pythium_arrhenomanes
Pythium_arrhenomanes_BR712	Heterokontophyta;Oomycetes;Pythiales;Pythiaceae;Pythium;Pythium_Clade_B;Pythium_arrhenomanes
Pythium_arrhenomanes_BR729	Heterokontophyta;Oomycetes;Pythiales;Pythiaceae;Pythium;Pythium_Clade_B;Pythium_arrhenomanes
Pythium_arrhenomanes_BR817	Heterokontophyta;Oomycetes;Pythiales;Pythiaceae;Pythium;Pythium_Clade_B;Pythium_arrhenomanes
Pythium_arrhenomanes_BR889	Heterokontophyta;Oomycetes;Pythiales;Pythiaceae;Pythium;Pythium_Clade_B;Pythium_arrhenomanes
Pythium_arrhenomanes_BR975	Heterokontophyta;Oomycetes;Pythiales;Pythiaceae;Pythium;Pythium_Clade_B;Pythium_arrhenomanes
Pythium_arrhenomanes_BR980	Heterokontophyta;Oomycetes;Pythiales;Pythiaceae;Pythium;Pythium_Clade_B;Pythium_arrhenomanes
Pythium_arrhenomanes_BR981	Heterokontophyta;Oomycetes;Pythiales;Pythiaceae;Pythium;Pythium_Clade_B;Pythium_arrhenomanes
Pythium_arrhenomanes_BR982	Heterokontophyta;Oomycetes;Pythiales;Pythiaceae;Pythium;Pythium_Clade_B;Pythium_arrhenomanes
Pythium_arrhenomanes_BR983	Heterokontophyta;Oomycetes;Pythiales;Pythiaceae;Pythium;Pythium_Clade_B;Pythium_arrhenomanes
Pythium_arrhenomanes_BR985	Heterokontophyta;Oomycetes;Pythiales;Pythiaceae;Pythium;Pythium_Clade_B;Pythium_arrhenomanes
Pythium_arrhenomanes_CBS32462	Heterokontophyta;Oomycetes;Pythiales;Pythiaceae;Pythium;Pythium_Clade_B;Pythium_arrhenomanes
Pythium_arrhenomanes_Lev1538	Heterokontophyta;Oomycetes;Pythiales;Pythiaceae;Pythium;Pythium_Clade_B;Pythium_arrhenomanes
Pythium_arrhenomanes_Lev1728	Heterokontophyta;Oomycetes;Pythiales;Pythiaceae;Pythium;Pythium_Clade_B;Pythium_arrhenomanes
Pythium_attrantheridium_DAOM230383	Heterokontophyta;Oomycetes;Pythiales;Pythiaceae;Pythium;Pythium_Clade_F;Pythium_attrantheridium
Pythium_attrantheridium_DAOM230386	Heterokontophyta;Oomycetes;Pythiales;Pythiaceae;Pythium;Pythium_Clade_F;Pythium_attrantheridium
Pythium_attrantheridium_DAOM230387	Heterokontophyta;Oomycetes;Pythiales;Pythiaceae;Pythium;Pythium_Clade_F;Pythium_attrantheridium
Pythium_attrantheridium_DAOM230388	Heterokontophyta;Oomycetes;Pythiales;Pythiaceae;Pythium;Pythium_Clade_F;Pythium_attrantheridium
Pythium_buismaniae_CBS28831	Heterokontophyta;Oomycetes;Pythiales;Pythiaceae;Pythium;Pythium_Clade_J;Pythium_buismaniae
Pythium_camurandrum_BR876	Heterokontophyta;Oomycetes;Pythiales;Pythiaceae;Pythium;Pythium_Clade_E;Pythium_camurandrum
Pythium_camurandrum_CBS124096	Heterokontophyta;Oomycetes;Pythiales;Pythiaceae;Pythium;Pythium_Clade_E;Pythium_camurandrum
Pythium_canariense_CBS112353	Heterokontophyta;Oomycetes;Pythiales;Pythiaceae;Pythium;Pythium_Clade_G;Pythium_canariense
Pythium_capillosum_CBS22294	Heterokontophyta;Oomycetes;Pythiales;Pythiaceae;Pythium;Pythium_Clade_B;Pythium_capillosum
Pythium_carolinianum_BR161	Heterokontophyta;Oomycetes;Pythiales;Pythiaceae;Pythium;Pythium_Clade_E;Pythium_carolinianum
Pythium_carolinianum_BR786	Heterokontophyta;Oomycetes;Pythiales;Pythiaceae;Pythium;Pythium_Clade_E;Pythium_carolinianum
Pythium_carolinianum_BR803	Heterokontophyta;Oomycetes;Pythiales;Pythiaceae;Pythium;Pythium_Clade_E;Pythium_carolinianum
Pythium_carolinianum_CBS122658	Heterokontophyta;Oomycetes;Pythiales;Pythiaceae;Pythium;Pythium_Clade_E;Pythium_carolinianum
Pythium_carolinianum_CBS122659	Heterokontophyta;Oomycetes;Pythiales;Pythiaceae;Pythium;Pythium_Clade_E;Pythium_carolinianum
Pythium_carolinianum_P19301	Heterokontophyta;Oomycetes;Pythiales;Pythiaceae;Pythium;Pythium_Clade_E;Pythium_carolinianum
Pythium_catenulatum_CBS22694	Heterokontophyta;Oomycetes;Pythiales;Pythiaceae;Pythium;Pythium_Clade_B;Pythium_catenulatum
Pythium_catenulatum_CBS46175	Heterokontophyta;Oomycetes;Pythiales;Pythiaceae;Pythium;Pythium_Clade_B;Pythium_catenulatum
Pythium_catenulatum_CBS84268	Heterokontophyta;Oomycetes;Pythiales;Pythiaceae;Pythium;Pythium_Clade_B;Pythium_catenulatum
Pythium_catenulatum_Lev1524	Heterokontophyta;Oomycetes;Pythiales;Pythiaceae;Pythium;Pythium_Clade_B;Pythium_catenulatum
Pythium_catenulatum_Lev1532	Heterokontophyta;Oomycetes;Pythiales;Pythiaceae;Pythium;Pythium_Clade_B;Pythium_catenulatum
Pythium_catenulatum_Lev1533	Heterokontophyta;Oomycetes;Pythiales;Pythiaceae;Pythium;Pythium_Clade_B;Pythium_catenulatum
Pythium_cf_dictyosporum_ADC0114	Heterokontophyta;Oomycetes;Pythiales;Pythiaceae;Pythium;Pythium_Clade_B;Pythium_cf_dictyosporum
Pythium_chondricola_CBS20385	Heterokontophyta;Oomycetes;Pythiales;Pythiaceae;Pythium;Pythium_Clade_B;Pythium_chondricola
Pythium_chondricola_CBS20685	Heterokontophyta;Oomycetes;Pythiales;Pythiaceae;Pythium;Pythium_Clade_B;Pythium_chondricola
Pythium_chondricola_CBS20785	Heterokontophyta;Oomycetes;Pythiales;Pythiaceae;Pythium;Pythium_Clade_B;Pythium_chondricola
Pythium_chondricola_CBS31293	Heterokontophyta;Oomycetes;Pythiales;Pythiaceae;Pythium;Pythium_Clade_B;Pythium_chondricola
Pythium_coloratum_BR1063	Heterokontophyta;Oomycetes;Pythiales;Pythiaceae;Pythium;Pythium_Clade_B;Pythium_coloratum
Pythium_coloratum_BR176	Heterokontophyta;Oomycetes;Pythiales;Pythiaceae;Pythium;Pythium_Clade_B;Pythium_coloratum
Pythium_coloratum_BR323	Heterokontophyta;Oomycetes;Pythiales;Pythiaceae;Pythium;Pythium_Clade_B;Pythium_coloratum
Pythium_coloratum_BR621	Heterokontophyta;Oomycetes;Pythiales;Pythiaceae;Pythium;Pythium_Clade_B;Pythium_coloratum
Pythium_coloratum_BR677	Heterokontophyta;Oomycetes;Pythiales;Pythiaceae;Pythium;Pythium_Clade_B;Pythium_coloratum
Pythium_coloratum_BR678	Heterokontophyta;Oomycetes;Pythiales;Pythiaceae;Pythium;Pythium_Clade_B;Pythium_coloratum
Pythium_coloratum_BR908	Heterokontophyta;Oomycetes;Pythiales;Pythiaceae;Pythium;Pythium_Clade_B;Pythium_coloratum
Pythium_coloratum_CBS15464	Heterokontophyta;Oomycetes;Pythiales;Pythiaceae;Pythium;Pythium_Clade_B;Pythium_coloratum
Pythium_conidiophorum_BR160	Heterokontophyta;Oomycetes;Pythiales;Pythiaceae;Pythium;Pythium_Clade_B;Pythium_conidiophorum
Pythium_conidiophorum_BR260	Heterokontophyta;Oomycetes;Pythiales;Pythiaceae;Pythium;Pythium_Clade_B;Pythium_conidiophorum
Pythium_conidiophorum_CBS22388	Heterokontophyta;Oomycetes;Pythiales;Pythiaceae;Pythium;Pythium_Clade_B;Pythium_conidiophorum
Pythium_conidiophorum_CBS22488	Heterokontophyta;Oomycetes;Pythiales;Pythiaceae;Pythium;Pythium_Clade_B;Pythium_conidiophorum
Pythium_conidiophorum_Lev1465	Heterokontophyta;Oomycetes;Pythiales;Pythiaceae;Pythium;Pythium_Clade_B;Pythium_conidiophorum
Pythium_conidiophorum_Lev1624	Heterokontophyta;Oomycetes;Pythiales;Pythiaceae;Pythium;Pythium_Clade_B;Pythium_conidiophorum
Pythium_contiguanum_CBS22194	Heterokontophyta;Oomycetes;Pythiales;Pythiaceae;Pythium;Pythium_Clade_B;Pythium_contiguanum
Pythium_cryptoirregulare_CBS118731	Heterokontophyta;Oomycetes;Pythiales;Pythiaceae;Pythium;Pythium_Clade_F;Pythium_cryptoirregulare
Pythium_cylindrosporum_CBS21894	Heterokontophyta;Oomycetes;Pythiales;Pythiaceae;Pythium;Pythium_Clade_F;Pythium_cylindrosporum
Pythium_cylindrosporum_DAOM232335	Heterokontophyta;Oomycetes;Pythiales;Pythiaceae;Pythium;Pythium_Clade_F;Pythium_cylindrosporum
Pythium_cystogenes_CBS67585	Heterokontophyta;Oomycetes;Pythiales;Pythiaceae;Pythium;Pythium_Clade_J;Pythium_cystogenes
Pythium_debaryanum_CBS75296	Heterokontophyta;Oomycetes;Pythiales;Pythiaceae;Pythium;Pythium_Clade_F;Pythium_debaryanum
Pythium_deliense_CBS11484	Heterokontophyta;Oomycetes;Pythiales;Pythiaceae;Pythium;Pythium_Clade_A;Pythium_deliense
Pythium_deliense_CBS31433	Heterokontophyta;Oomycetes;Pythiales;Pythiaceae;Pythium;Pythium_Clade_A;Pythium_deliense
Pythium_deliense_Lev2095	Heterokontophyta;Oomycetes;Pythiales;Pythiaceae;Pythium;Pythium_Clade_A;Pythium_deliense
Pythium_diclinum_CBS52674	Heterokontophyta;Oomycetes;Pythiales;Pythiaceae;Pythium;Pythium_Clade_B;Pythium_diclinum
Pythium_diclinum_CBS66479	Heterokontophyta;Oomycetes;Pythiales;Pythiaceae;Pythium;Pythium_Clade_B;Pythium_diclinum
Pythium_dimorphum_CBS40672	Heterokontophyta;Oomycetes;Pythiales;Pythiaceae;Pythium;Pythium_Clade_H;Pythium_dimorphum
Pythium_dissimile_CBS15564	Heterokontophyta;Oomycetes;Pythiales;Pythiaceae;Pythium;Pythium_Clade_B;Pythium_dissimile
Pythium_dissimile_CBS52374	Heterokontophyta;Oomycetes;Pythiales;Pythiaceae;Pythium;Pythium_Clade_B;Pythium_dissimile
Pythium_dissotocum_BR127	Heterokontophyta;Oomycetes;Pythiales;Pythiaceae;Pythium;Pythium_Clade_B;Pythium_dissotocum
Pythium_dissotocum_CBS16668	Heterokontophyta;Oomycetes;Pythiales;Pythiaceae;Pythium;Pythium_Clade_B;Pythium_dissotocum
Pythium_dissotocum_DAOM229134	Heterokontophyta;Oomycetes;Pythiales;Pythiaceae;Pythium;Pythium_Clade_B;Pythium_dissotocum
Pythium_echinulatum_CBS28164	Heterokontophyta;Oomycetes;Pythiales;Pythiaceae;Pythium;Pythium_Clade_E;Pythium_echinulatum
Pythium_emineosum_BR479	Heterokontophyta;Oomycetes;Pythiales;Pythiaceae;Pythium;Pythium_Clade_F;Pythium_emineosum
Pythium_emineosum_BR836	Heterokontophyta;Oomycetes;Pythiales;Pythiaceae;Pythium;Pythium_Clade_F;Pythium_emineosum
Pythium_erinaceus_CBS50580	Heterokontophyta;Oomycetes;Pythiales;Pythiaceae;Pythium;Pythium_Clade_E;Pythium_erinaceus
Pythium_erinaceus_Lev1620	Heterokontophyta;Oomycetes;Pythiales;Pythiaceae;Pythium;Pythium_Clade_E;Pythium_erinaceus
Pythium_flevoense_CBS23372	Heterokontophyta;Oomycetes;Pythiales;Pythiaceae;Pythium;Pythium_Clade_B;Pythium_flevoense
Pythium_flevoense_CBS23472	Heterokontophyta;Oomycetes;Pythiales;Pythiaceae;Pythium;Pythium_Clade_B;Pythium_flevoense
Pythium_flevoense_CBS23672	Heterokontophyta;Oomycetes;Pythiales;Pythiaceae;Pythium;Pythium_Clade_B;Pythium_flevoense
Pythium_flevoense_CBS27881	Heterokontophyta;Oomycetes;Pythiales;Pythiaceae;Pythium;Pythium_Clade_B;Pythium_flevoense
Pythium_folliculosum_CBS22094	Heterokontophyta;Oomycetes;Pythiales;Pythiaceae;Pythium;Pythium_Clade_B;Pythium_folliculosum
Pythium_glomeratum_CBS119165	Heterokontophyta;Oomycetes;Pythiales;Pythiaceae;Pythium;Pythium_Clade_I;Pythium_glomeratum
Pythium_glomeratum_CBS120914	Heterokontophyta;Oomycetes;Pythiales;Pythiaceae;Pythium;Pythium_Clade_I;Pythium_glomeratum
Pythium_glomeratum_CBS122644	Heterokontophyta;Oomycetes;Pythiales;Pythiaceae;Pythium;Pythium_Clade_I;Pythium_glomeratum
Pythium_glomeratum_CBS122651	Heterokontophyta;Oomycetes;Pythiales;Pythiaceae;Pythium;Pythium_Clade_I;Pythium_glomeratum
Pythium_graminicola_CBS32762	Heterokontophyta;Oomycetes;Pythiales;Pythiaceae;Pythium;Pythium_Clade_B;Pythium_graminicola
Pythium_grandisporangium_CBS28679	Heterokontophyta;Oomycetes;Pythiales;Pythiaceae;Pythium;Pythium_Clade_C;Pythium_grandisporangium
Pythium_helicandrum_CBS39354	Heterokontophyta;Oomycetes;Pythiales;Pythiaceae;Pythium;Pythium_Clade_H;Pythium_helicandrum
Pythium_helicandrum_CBS52774	Heterokontophyta;Oomycetes;Pythiales;Pythiaceae;Pythium;Pythium_Clade_H;Pythium_helicandrum
Pythium_helicandrum_CBS69479	Heterokontophyta;Oomycetes;Pythiales;Pythiaceae;Pythium;Pythium_Clade_H;Pythium_helicandrum
Pythium_helicandrum_CBS84468	Heterokontophyta;Oomycetes;Pythiales;Pythiaceae;Pythium;Pythium_Clade_H;Pythium_helicandrum
Pythium_heterothallicum_ADC9868	Heterokontophyta;Oomycetes;Pythiales;Pythiaceae;Pythium;Pythium_Clade_I;Pythium_heterothallicum
Pythium_heterothallicum_BR440	Heterokontophyta;Oomycetes;Pythiales;Pythiaceae;Pythium;Pythium_Clade_I;Pythium_heterothallicum
Pythium_heterothallicum_BR749	Heterokontophyta;Oomycetes;Pythiales;Pythiaceae;Pythium;Pythium_Clade_I;Pythium_heterothallicum
Pythium_heterothallicum_BR806	Heterokontophyta;Oomycetes;Pythiales;Pythiaceae;Pythium;Pythium_Clade_I;Pythium_heterothallicum
Pythium_heterothallicum_BR828	Heterokontophyta;Oomycetes;Pythiales;Pythiaceae;Pythium;Pythium_Clade_I;Pythium_heterothallicum
Pythium_heterothallicum_CBS122655	Heterokontophyta;Oomycetes;Pythiales;Pythiaceae;Pythium;Pythium_Clade_I;Pythium_heterothallicum
Pythium_heterothallicum_CBS122656	Heterokontophyta;Oomycetes;Pythiales;Pythiaceae;Pythium;Pythium_Clade_I;Pythium_heterothallicum
Pythium_heterothallicum_CBS45067	Heterokontophyta;Oomycetes;Pythiales;Pythiaceae;Pythium;Pythium_Clade_I;Pythium_heterothallicum
Pythium_heterothallicum_DAOM229136	Heterokontophyta;Oomycetes;Pythiales;Pythiaceae;Pythium;Pythium_Clade_I;Pythium_heterothallicum
Pythium_heterothallicum_DAOM229137	Heterokontophyta;Oomycetes;Pythiales;Pythiaceae;Pythium;Pythium_Clade_I;Pythium_heterothallicum
Pythium_heterothallicum_DAOM229138	Heterokontophyta;Oomycetes;Pythiales;Pythiaceae;Pythium;Pythium_Clade_I;Pythium_heterothallicum
Pythium_heterothallicum_DAOM229140	Heterokontophyta;Oomycetes;Pythiales;Pythiaceae;Pythium;Pythium_Clade_I;Pythium_heterothallicum
Pythium_heterothallicum_Lev1590	Heterokontophyta;Oomycetes;Pythiales;Pythiaceae;Pythium;Pythium_Clade_I;Pythium_heterothallicum
Pythium_hydnosporum_CBS25360	Heterokontophyta;Oomycetes;Pythiales;Pythiaceae;Pythium;Pythium_Clade_D;Pythium_hydnosporum
Pythium_hypogynum_CBS23494	Heterokontophyta;Oomycetes;Pythiales;Pythiaceae;Pythium;Pythium_Clade_E;Pythium_hypogynum
Pythium_inflatum_CBS16868	Heterokontophyta;Oomycetes;Pythiales;Pythiaceae;Pythium;Pythium_Clade_B;Pythium_inflatum
Pythium_insidiosum_CBS57485	Heterokontophyta;Oomycetes;Pythiales;Pythiaceae;Pythium;Pythium_Clade_C;Pythium_insidiosum
Pythium_insidiosum_CBS57785	Heterokontophyta;Oomycetes;Pythiales;Pythiaceae;Pythium;Pythium_Clade_C;Pythium_insidiosum
Pythium_insidiosum_CBS57885	Heterokontophyta;Oomycetes;Pythiales;Pythiaceae;Pythium;Pythium_Clade_C;Pythium_insidiosum
Pythium_insidiosum_CBS58085	Heterokontophyta;Oomycetes;Pythiales;Pythiaceae;Pythium;Pythium_Clade_C;Pythium_insidiosum
Pythium_intermedium_BR1042	Heterokontophyta;Oomycetes;Pythiales;Pythiaceae;Pythium;Pythium_Clade_F;Pythium_intermedium
Pythium_intermedium_BR128	Heterokontophyta;Oomycetes;Pythiales;Pythiaceae;Pythium;Pythium_Clade_F;Pythium_intermedium
Pythium_intermedium_BR339	Heterokontophyta;Oomycetes;Pythiales;Pythiaceae;Pythium;Pythium_Clade_F;Pythium_intermedium
Pythium_intermedium_BR485	Heterokontophyta;Oomycetes;Pythiales;Pythiaceae;Pythium;Pythium_Clade_F;Pythium_intermedium
Pythium_intermedium_BR707	Heterokontophyta;Oomycetes;Pythiales;Pythiaceae;Pythium;Pythium_Clade_F;Pythium_intermedium
Pythium_intermedium_BR734	Heterokontophyta;Oomycetes;Pythiales;Pythiaceae;Pythium;Pythium_Clade_F;Pythium_intermedium
Pythium_intermedium_BR869	Heterokontophyta;Oomycetes;Pythiales;Pythiaceae;Pythium;Pythium_Clade_F;Pythium_intermedium
Pythium_intermedium_BR924	Heterokontophyta;Oomycetes;Pythiales;Pythiaceae;Pythium;Pythium_Clade_F;Pythium_intermedium
Pythium_intermedium_CBS26638	Heterokontophyta;Oomycetes;Pythiales;Pythiaceae;Pythium;Pythium_Clade_F;Pythium_intermedium
Pythium_irregulare_ADC0838	Heterokontophyta;Oomycetes;Pythiales;Pythiaceae;Pythium;Pythium_Clade_F;Pythium_irregulare
Pythium_irregulare_BR1000	Heterokontophyta;Oomycetes;Pythiales;Pythiaceae;Pythium;Pythium_Clade_F;Pythium_irregulare
Pythium_irregulare_BR1001	Heterokontophyta;Oomycetes;Pythiales;Pythiaceae;Pythium;Pythium_Clade_F;Pythium_irregulare
Pythium_irregulare_BR1002	Heterokontophyta;Oomycetes;Pythiales;Pythiaceae;Pythium;Pythium_Clade_F;Pythium_irregulare
Pythium_irregulare_BR1003	Heterokontophyta;Oomycetes;Pythiales;Pythiaceae;Pythium;Pythium_Clade_F;Pythium_irregulare
Pythium_irregulare_BR1004	Heterokontophyta;Oomycetes;Pythiales;Pythiaceae;Pythium;Pythium_Clade_F;Pythium_irregulare
Pythium_irregulare_BR1005	Heterokontophyta;Oomycetes;Pythiales;Pythiaceae;Pythium;Pythium_Clade_F;Pythium_irregulare
Pythium_irregulare_BR1006	Heterokontophyta;Oomycetes;Pythiales;Pythiaceae;Pythium;Pythium_Clade_F;Pythium_irregulare
Pythium_irregulare_BR1008	Heterokontophyta;Oomycetes;Pythiales;Pythiaceae;Pythium;Pythium_Clade_F;Pythium_irregulare
Pythium_irregulare_BR1009	Heterokontophyta;Oomycetes;Pythiales;Pythiaceae;Pythium;Pythium_Clade_F;Pythium_irregulare
Pythium_irregulare_BR1013	Heterokontophyta;Oomycetes;Pythiales;Pythiaceae;Pythium;Pythium_Clade_F;Pythium_irregulare
Pythium_irregulare_BR1014	Heterokontophyta;Oomycetes;Pythiales;Pythiaceae;Pythium;Pythium_Clade_F;Pythium_irregulare
Pythium_irregulare_BR1015	Heterokontophyta;Oomycetes;Pythiales;Pythiaceae;Pythium;Pythium_Clade_F;Pythium_irregulare
Pythium_irregulare_BR1016	Heterokontophyta;Oomycetes;Pythiales;Pythiaceae;Pythium;Pythium_Clade_F;Pythium_irregulare
Pythium_irregulare_BR1017	Heterokontophyta;Oomycetes;Pythiales;Pythiaceae;Pythium;Pythium_Clade_F;Pythium_irregulare
Pythium_irregulare_BR1018	Heterokontophyta;Oomycetes;Pythiales;Pythiaceae;Pythium;Pythium_Clade_F;Pythium_irregulare
Pythium_irregulare_BR1019	Heterokontophyta;Oomycetes;Pythiales;Pythiaceae;Pythium;Pythium_Clade_F;Pythium_irregulare
Pythium_irregulare_BR1021	Heterokontophyta;Oomycetes;Pythiales;Pythiaceae;Pythium;Pythium_Clade_F;Pythium_irregulare
Pythium_irregulare_BR1022	Heterokontophyta;Oomycetes;Pythiales;Pythiaceae;Pythium;Pythium_Clade_F;Pythium_irregulare
Pythium_irregulare_BR1039	Heterokontophyta;Oomycetes;Pythiales;Pythiaceae;Pythium;Pythium_Clade_F;Pythium_irregulare
Pythium_irregulare_BR1040	Heterokontophyta;Oomycetes;Pythiales;Pythiaceae;Pythium;Pythium_Clade_F;Pythium_irregulare
Pythium_irregulare_BR1051	Heterokontophyta;Oomycetes;Pythiales;Pythiaceae;Pythium;Pythium_Clade_F;Pythium_irregulare
Pythium_irregulare_BR1052	Heterokontophyta;Oomycetes;Pythiales;Pythiaceae;Pythium;Pythium_Clade_F;Pythium_irregulare
Pythium_irregulare_BR1068	Heterokontophyta;Oomycetes;Pythiales;Pythiaceae;Pythium;Pythium_Clade_F;Pythium_irregulare
Pythium_irregulare_BR387	Heterokontophyta;Oomycetes;Pythiales;Pythiaceae;Pythium;Pythium_Clade_F;Pythium_irregulare
Pythium_irregulare_BR469	Heterokontophyta;Oomycetes;Pythiales;Pythiaceae;Pythium;Pythium_Clade_F;Pythium_irregulare
Pythium_irregulare_BR598	Heterokontophyta;Oomycetes;Pythiales;Pythiaceae;Pythium;Pythium_Clade_F;Pythium_irregulare
Pythium_irregulare_BR629	Heterokontophyta;Oomycetes;Pythiales;Pythiaceae;Pythium;Pythium_Clade_F;Pythium_irregulare
Pythium_irregulare_BR630	Heterokontophyta;Oomycetes;Pythiales;Pythiaceae;Pythium;Pythium_Clade_F;Pythium_irregulare
Pythium_irregulare_BR631	Heterokontophyta;Oomycetes;Pythiales;Pythiaceae;Pythium;Pythium_Clade_F;Pythium_irregulare
Pythium_irregulare_BR636	Heterokontophyta;Oomycetes;Pythiales;Pythiaceae;Pythium;Pythium_Clade_F;Pythium_irregulare
Pythium_irregulare_BR642	Heterokontophyta;Oomycetes;Pythiales;Pythiaceae;Pythium;Pythium_Clade_F;Pythium_irregulare
Pythium_irregulare_BR722	Heterokontophyta;Oomycetes;Pythiales;Pythiaceae;Pythium;Pythium_Clade_F;Pythium_irregulare
Pythium_irregulare_BR733	Heterokontophyta;Oomycetes;Pythiales;Pythiaceae;Pythium;Pythium_Clade_F;Pythium_irregulare
Pythium_irregulare_BR772	Heterokontophyta;Oomycetes;Pythiales;Pythiaceae;Pythium;Pythium_Clade_F;Pythium_irregulare
Pythium_irregulare_BR775	Heterokontophyta;Oomycetes;Pythiales;Pythiaceae;Pythium;Pythium_Clade_F;Pythium_irregulare
Pythium_irregulare_BR778	Heterokontophyta;Oomycetes;Pythiales;Pythiaceae;Pythium;Pythium_Clade_F;Pythium_irregulare
Pythium_irregulare_BR802	Heterokontophyta;Oomycetes;Pythiales;Pythiaceae;Pythium;Pythium_Clade_F;Pythium_irregulare
Pythium_irregulare_BR804	Heterokontophyta;Oomycetes;Pythiales;Pythiaceae;Pythium;Pythium_Clade_F;Pythium_irregulare
Pythium_irregulare_BR808	Heterokontophyta;Oomycetes;Pythiales;Pythiaceae;Pythium;Pythium_Clade_F;Pythium_irregulare
Pythium_irregulare_BR811	Heterokontophyta;Oomycetes;Pythiales;Pythiaceae;Pythium;Pythium_Clade_F;Pythium_irregulare
Pythium_irregulare_BR812	Heterokontophyta;Oomycetes;Pythiales;Pythiaceae;Pythium;Pythium_Clade_F;Pythium_irregulare
Pythium_irregulare_BR815	Heterokontophyta;Oomycetes;Pythiales;Pythiaceae;Pythium;Pythium_Clade_F;Pythium_irregulare
Pythium_irregulare_BR818	Heterokontophyta;Oomycetes;Pythiales;Pythiaceae;Pythium;Pythium_Clade_F;Pythium_irregulare
Pythium_irregulare_BR819	Heterokontophyta;Oomycetes;Pythiales;Pythiaceae;Pythium;Pythium_Clade_F;Pythium_irregulare
Pythium_irregulare_BR820	Heterokontophyta;Oomycetes;Pythiales;Pythiaceae;Pythium;Pythium_Clade_F;Pythium_irregulare
Pythium_irregulare_BR821	Heterokontophyta;Oomycetes;Pythiales;Pythiaceae;Pythium;Pythium_Clade_F;Pythium_irregulare
Pythium_irregulare_BR870	Heterokontophyta;Oomycetes;Pythiales;Pythiaceae;Pythium;Pythium_Clade_F;Pythium_irregulare
Pythium_irregulare_BR900	Heterokontophyta;Oomycetes;Pythiales;Pythiaceae;Pythium;Pythium_Clade_F;Pythium_irregulare
Pythium_irregulare_BR909	Heterokontophyta;Oomycetes;Pythiales;Pythiaceae;Pythium;Pythium_Clade_F;Pythium_irregulare
Pythium_irregulare_BR911	Heterokontophyta;Oomycetes;Pythiales;Pythiaceae;Pythium;Pythium_Clade_F;Pythium_irregulare
Pythium_irregulare_BR912	Heterokontophyta;Oomycetes;Pythiales;Pythiaceae;Pythium;Pythium_Clade_F;Pythium_irregulare
Pythium_irregulare_BR914	Heterokontophyta;Oomycetes;Pythiales;Pythiaceae;Pythium;Pythium_Clade_F;Pythium_irregulare
Pythium_irregulare_BR918	Heterokontophyta;Oomycetes;Pythiales;Pythiaceae;Pythium;Pythium_Clade_F;Pythium_irregulare
Pythium_irregulare_BR920	Heterokontophyta;Oomycetes;Pythiales;Pythiaceae;Pythium;Pythium_Clade_F;Pythium_irregulare
Pythium_irregulare_BR921	Heterokontophyta;Oomycetes;Pythiales;Pythiaceae;Pythium;Pythium_Clade_F;Pythium_irregulare
Pythium_irregulare_BR923	Heterokontophyta;Oomycetes;Pythiales;Pythiaceae;Pythium;Pythium_Clade_F;Pythium_irregulare
Pythium_irregulare_BR933	Heterokontophyta;Oomycetes;Pythiales;Pythiaceae;Pythium;Pythium_Clade_F;Pythium_irregulare
Pythium_irregulare_BR934	Heterokontophyta;Oomycetes;Pythiales;Pythiaceae;Pythium;Pythium_Clade_F;Pythium_irregulare
Pythium_irregulare_BR940	Heterokontophyta;Oomycetes;Pythiales;Pythiaceae;Pythium;Pythium_Clade_F;Pythium_irregulare
Pythium_irregulare_BR946	Heterokontophyta;Oomycetes;Pythiales;Pythiaceae;Pythium;Pythium_Clade_F;Pythium_irregulare
Pythium_irregulare_BR947	Heterokontophyta;Oomycetes;Pythiales;Pythiaceae;Pythium;Pythium_Clade_F;Pythium_irregulare
Pythium_irregulare_BR948	Heterokontophyta;Oomycetes;Pythiales;Pythiaceae;Pythium;Pythium_Clade_F;Pythium_irregulare
Pythium_irregulare_BR959	Heterokontophyta;Oomycetes;Pythiales;Pythiaceae;Pythium;Pythium_Clade_F;Pythium_irregulare
Pythium_irregulare_BR960	Heterokontophyta;Oomycetes;Pythiales;Pythiaceae;Pythium;Pythium_Clade_F;Pythium_irregulare
Pythium_irregulare_BR961	Heterokontophyta;Oomycetes;Pythiales;Pythiaceae;Pythium;Pythium_Clade_F;Pythium_irregulare
Pythium_irregulare_BR962	Heterokontophyta;Oomycetes;Pythiales;Pythiaceae;Pythium;Pythium_Clade_F;Pythium_irregulare
Pythium_irregulare_BR963	Heterokontophyta;Oomycetes;Pythiales;Pythiaceae;Pythium;Pythium_Clade_F;Pythium_irregulare
Pythium_irregulare_BR964	Heterokontophyta;Oomycetes;Pythiales;Pythiaceae;Pythium;Pythium_Clade_F;Pythium_irregulare
Pythium_irregulare_BR965	Heterokontophyta;Oomycetes;Pythiales;Pythiaceae;Pythium;Pythium_Clade_F;Pythium_irregulare
Pythium_irregulare_BR966	Heterokontophyta;Oomycetes;Pythiales;Pythiaceae;Pythium;Pythium_Clade_F;Pythium_irregulare
Pythium_irregulare_BR967	Heterokontophyta;Oomycetes;Pythiales;Pythiaceae;Pythium;Pythium_Clade_F;Pythium_irregulare
Pythium_irregulare_BR969	Heterokontophyta;Oomycetes;Pythiales;Pythiaceae;Pythium;Pythium_Clade_F;Pythium_irregulare
Pythium_irregulare_BR970	Heterokontophyta;Oomycetes;Pythiales;Pythiaceae;Pythium;Pythium_Clade_F;Pythium_irregulare
Pythium_irregulare_BR971	Heterokontophyta;Oomycetes;Pythiales;Pythiaceae;Pythium;Pythium_Clade_F;Pythium_irregulare
Pythium_irregulare_BR972	Heterokontophyta;Oomycetes;Pythiales;Pythiaceae;Pythium;Pythium_Clade_F;Pythium_irregulare
Pythium_irregulare_BR979	Heterokontophyta;Oomycetes;Pythiales;Pythiaceae;Pythium;Pythium_Clade_F;Pythium_irregulare
Pythium_irregulare_BR994	Heterokontophyta;Oomycetes;Pythiales;Pythiaceae;Pythium;Pythium_Clade_F;Pythium_irregulare
Pythium_irregulare_BR995	Heterokontophyta;Oomycetes;Pythiales;Pythiaceae;Pythium;Pythium_Clade_F;Pythium_irregulare
Pythium_irregulare_BR996	Heterokontophyta;Oomycetes;Pythiales;Pythiaceae;Pythium;Pythium_Clade_F;Pythium_irregulare
Pythium_irregulare_BR997	Heterokontophyta;Oomycetes;Pythiales;Pythiaceae;Pythium;Pythium_Clade_F;Pythium_irregulare
Pythium_irregulare_BR999	Heterokontophyta;Oomycetes;Pythiales;Pythiaceae;Pythium;Pythium_Clade_F;Pythium_irregulare
Pythium_irregulare_CBS25028	Heterokontophyta;Oomycetes;Pythiales;Pythiaceae;Pythium;Pythium_Clade_F;Pythium_irregulare
Pythium_irregulare_CBS74996	Heterokontophyta;Oomycetes;Pythiales;Pythiaceae;Pythium;Pythium_Clade_F;Pythium_irregulare
Pythium_irregulare_DAOM232336	Heterokontophyta;Oomycetes;Pythiales;Pythiaceae;Pythium;Pythium_Clade_F;Pythium_irregulare
Pythium_irregulare_Lev1680	Heterokontophyta;Oomycetes;Pythiales;Pythiaceae;Pythium;Pythium_Clade_F;Pythium_irregulare
Pythium_irregulare_Lev2120	Heterokontophyta;Oomycetes;Pythiales;Pythiaceae;Pythium;Pythium_Clade_F;Pythium_irregulare
Pythium_irregulare_Lev2151	Heterokontophyta;Oomycetes;Pythiales;Pythiaceae;Pythium;Pythium_Clade_F;Pythium_irregulare
Pythium_irregulare_Lev3105	Heterokontophyta;Oomycetes;Pythiales;Pythiaceae;Pythium;Pythium_Clade_F;Pythium_irregulare
Pythium_iwayamai_CBS15664	Heterokontophyta;Oomycetes;Pythiales;Pythiaceae;Pythium;Pythium_Clade_G;Pythium_iwayamai
Pythium_kashmirense_CBS122908	Heterokontophyta;Oomycetes;Pythiales;Pythiaceae;Pythium;Pythium_Clade_B;Pythium_kashmirense
Pythium_kunmingense_CBS55088	Heterokontophyta;Oomycetes;Pythiales;Pythiaceae;Pythium;Pythium_Clade_F;Pythium_kunmingense
Pythium_longandrum_CBS112355	Heterokontophyta;Oomycetes;Pythiales;Pythiaceae;Pythium;Pythium_Clade_E;Pythium_longandrum
Pythium_longandrum_CBS122660	Heterokontophyta;Oomycetes;Pythiales;Pythiaceae;Pythium;Pythium_Clade_E;Pythium_longandrum
Pythium_longisporangium_CBS122646	Heterokontophyta;Oomycetes;Pythiales;Pythiaceae;Pythium;Pythium_Clade_E;Pythium_longisporangium
Pythium_lucens_CBS113342	Heterokontophyta;Oomycetes;Pythiales;Pythiaceae;Pythium;Pythium_Clade_F;Pythium_lucens
Pythium_lutarium_CBS22288	Heterokontophyta;Oomycetes;Pythiales;Pythiaceae;Pythium;Pythium_Clade_B;Pythium_lutarium
Pythium_lycopersicum_CBS122909	Heterokontophyta;Oomycetes;Pythiales;Pythiaceae;Pythium;Pythium_Clade_D;Pythium_lycopersicum
Pythium_macrosporum_ADC0029	Heterokontophyta;Oomycetes;Pythiales;Pythiaceae;Pythium;Pythium_Clade_F;Pythium_macrosporum
Pythium_macrosporum_CBS57480	Heterokontophyta;Oomycetes;Pythiales;Pythiaceae;Pythium;Pythium_Clade_F;Pythium_macrosporum
Pythium_mamillatum_BR648	Heterokontophyta;Oomycetes;Pythiales;Pythiaceae;Pythium;Pythium_Clade_F;Pythium_mamillatum
Pythium_mamillatum_BR765	Heterokontophyta;Oomycetes;Pythiales;Pythiaceae;Pythium;Pythium_Clade_F;Pythium_mamillatum
Pythium_mamillatum_CBS25128	Heterokontophyta;Oomycetes;Pythiales;Pythiaceae;Pythium;Pythium_Clade_F;Pythium_mamillatum
Pythium_marsipium_CBS77381	Heterokontophyta;Oomycetes;Pythiales;Pythiaceae;Pythium;Pythium_Clade_E;Pythium_marsipium
Pythium_mastophorum_ADC0158	Heterokontophyta;Oomycetes;Pythiales;Pythiaceae;Pythium;Pythium_Clade_J;Pythium_mastophorum
Pythium_mastophorum_CBS37572	Heterokontophyta;Oomycetes;Pythiales;Pythiaceae;Pythium;Pythium_Clade_J;Pythium_mastophorum
Pythium_megalacanthum_DAOM229154	Heterokontophyta;Oomycetes;Pythiales;Pythiaceae;Pythium;Pythium_Clade_J;Pythium_megalacanthum
Pythium_middletonii_CBS52874	Heterokontophyta;Oomycetes;Pythiales;Pythiaceae;Pythium;Pythium_Clade_E;Pythium_middletonii
Pythium_minus_CBS122657	Heterokontophyta;Oomycetes;Pythiales;Pythiaceae;Pythium;Pythium_Clade_E;Pythium_minus
Pythium_minus_CBS22688	Heterokontophyta;Oomycetes;Pythiales;Pythiaceae;Pythium;Pythium_Clade_E;Pythium_minus
Pythium_monospermum_BR1031	Heterokontophyta;Oomycetes;Pythiales;Pythiaceae;Pythium;Pythium_Clade_A;Pythium_monospermum
Pythium_monospermum_BR1032	Heterokontophyta;Oomycetes;Pythiales;Pythiaceae;Pythium;Pythium_Clade_A;Pythium_monospermum
Pythium_monospermum_CBS15873	Heterokontophyta;Oomycetes;Pythiales;Pythiaceae;Pythium;Pythium_Clade_A;Pythium_monospermum
Pythium_multisporum_CBS47050	Heterokontophyta;Oomycetes;Pythiales;Pythiaceae;Pythium;Pythium_Clade_E;Pythium_multisporum
Pythium_myriotylum_CBS25470	Heterokontophyta;Oomycetes;Pythiales;Pythiaceae;Pythium;Pythium_Clade_B;Pythium_myriotylum
Pythium_myriotylum_CBS69579	Heterokontophyta;Oomycetes;Pythiales;Pythiaceae;Pythium;Pythium_Clade_B;Pythium_myriotylum
Pythium_myriotylum_Lev1529	Heterokontophyta;Oomycetes;Pythiales;Pythiaceae;Pythium;Pythium_Clade_B;Pythium_myriotylum
Pythium_myriotylum_Lev1737	Heterokontophyta;Oomycetes;Pythiales;Pythiaceae;Pythium;Pythium_Clade_B;Pythium_myriotylum
Pythium_nagaii_BR602	Heterokontophyta;Oomycetes;Pythiales;Pythiaceae;Pythium;Pythium_Clade_G;Pythium_nagaii
Pythium_nagaii_BR646	Heterokontophyta;Oomycetes;Pythiales;Pythiaceae;Pythium;Pythium_Clade_G;Pythium_nagaii
Pythium_nagaii_CBS77996	Heterokontophyta;Oomycetes;Pythiales;Pythiaceae;Pythium;Pythium_Clade_G;Pythium_nagaii
Pythium_nodosum_CBS102274	Heterokontophyta;Oomycetes;Pythiales;Pythiaceae;Pythium;Pythium_Clade_J;Pythium_nodosum
Pythium_nodosum_CBS122661	Heterokontophyta;Oomycetes;Pythiales;Pythiaceae;Pythium;Pythium_Clade_J;Pythium_nodosum
Pythium_nunn_CBS80896	Heterokontophyta;Oomycetes;Pythiales;Pythiaceae;Pythium;Pythium_Clade_J;Pythium_nunn
Pythium_nunn_Lev2098	Heterokontophyta;Oomycetes;Pythiales;Pythiaceae;Pythium;Pythium_Clade_J;Pythium_nunn
Pythium_okanoganense_CBS31581	Heterokontophyta;Oomycetes;Pythiales;Pythiaceae;Pythium;Pythium_Clade_G;Pythium_okanoganense
Pythium_okanoganense_CBS70183	Heterokontophyta;Oomycetes;Pythiales;Pythiaceae;Pythium;Pythium_Clade_G;Pythium_okanoganense
Pythium_oligandrum_BR252	Heterokontophyta;Oomycetes;Pythiales;Pythiaceae;Pythium;Pythium_Clade_D;Pythium_oligandrum
Pythium_oligandrum_CBS38234	Heterokontophyta;Oomycetes;Pythiales;Pythiaceae;Pythium;Pythium_Clade_D;Pythium_oligandrum
Pythium_oopapillum_BR180	Heterokontophyta;Oomycetes;Pythiales;Pythiaceae;Pythium;Pythium_Clade_B;Pythium_oopapillum
Pythium_oopapillum_BR632	Heterokontophyta;Oomycetes;Pythiales;Pythiaceae;Pythium;Pythium_Clade_B;Pythium_oopapillum
Pythium_oopapillum_BR641	Heterokontophyta;Oomycetes;Pythiales;Pythiaceae;Pythium;Pythium_Clade_B;Pythium_oopapillum
Pythium_ornacarpum_CBS112350	Heterokontophyta;Oomycetes;Pythiales;Pythiaceae;Pythium;Pythium_Clade_E;Pythium_ornacarpum
Pythium_ornamentatum_CBS122665	Heterokontophyta;Oomycetes;Pythiales;Pythiaceae;Pythium;Pythium_Clade_D;Pythium_ornamentatum
Pythium_orthogonon_CBS37672	Heterokontophyta;Oomycetes;Pythiales;Pythiaceae;Pythium;Pythium_Clade_J;Pythium_orthogonon
Pythium_pachycaule_BR679	Heterokontophyta;Oomycetes;Pythiales;Pythiaceae;Pythium;Pythium_Clade_B;Pythium_pachycaule
Pythium_pachycaule_CBS22494	Heterokontophyta;Oomycetes;Pythiales;Pythiaceae;Pythium;Pythium_Clade_B;Pythium_pachycaule
Pythium_pachycaule_CBS22594	Heterokontophyta;Oomycetes;Pythiales;Pythiaceae;Pythium;Pythium_Clade_B;Pythium_pachycaule
Pythium_pachycaule_CBS22788	Heterokontophyta;Oomycetes;Pythiales;Pythiaceae;Pythium;Pythium_Clade_B;Pythium_pachycaule
Pythium_paddicum_CBS69883	Heterokontophyta;Oomycetes;Pythiales;Pythiaceae;Pythium;Pythium_Clade_G;Pythium_paddicum
Pythium_papilogynum_CBS122648	Heterokontophyta;Oomycetes;Pythiales;Pythiaceae;Pythium;Pythium_Clade_E;Pythium_papilogynum
Pythium_paroecandrum_ADC9909	Heterokontophyta;Oomycetes;Pythiales;Pythiaceae;Pythium;Pythium_Clade_F;Pythium_paroecandrum
Pythium_paroecandrum_ADC9910	Heterokontophyta;Oomycetes;Pythiales;Pythiaceae;Pythium;Pythium_Clade_F;Pythium_paroecandrum
Pythium_paroecandrum_BR601	Heterokontophyta;Oomycetes;Pythiales;Pythiaceae;Pythium;Pythium_Clade_F;Pythium_paroecandrum
Pythium_paroecandrum_BR773	Heterokontophyta;Oomycetes;Pythiales;Pythiaceae;Pythium;Pythium_Clade_F;Pythium_paroecandrum
Pythium_paroecandrum_BR774	Heterokontophyta;Oomycetes;Pythiales;Pythiaceae;Pythium;Pythium_Clade_F;Pythium_paroecandrum
Pythium_paroecandrum_BR807	Heterokontophyta;Oomycetes;Pythiales;Pythiaceae;Pythium;Pythium_Clade_F;Pythium_paroecandrum
Pythium_paroecandrum_BR929	Heterokontophyta;Oomycetes;Pythiales;Pythiaceae;Pythium;Pythium_Clade_F;Pythium_paroecandrum
Pythium_paroecandrum_CBS15764	Heterokontophyta;Oomycetes;Pythiales;Pythiaceae;Pythium;Pythium_Clade_F;Pythium_paroecandrum
Pythium_parvum_CBS22588	Heterokontophyta;Oomycetes;Pythiales;Pythiaceae;Pythium;Pythium_Clade_E;Pythium_parvum
Pythium_pectinolyticum_CBS122643	Heterokontophyta;Oomycetes;Pythiales;Pythiaceae;Pythium;Pythium_Clade_B;Pythium_pectinolyticum
Pythium_periilum_CBS16968	Heterokontophyta;Oomycetes;Pythiales;Pythiaceae;Pythium;Pythium_Clade_B;Pythium_periilum
Pythium_periplocum_CBS122664	Heterokontophyta;Oomycetes;Pythiales;Pythiaceae;Pythium;Pythium_Clade_D;Pythium_periplocum
Pythium_periplocum_CBS17068	Heterokontophyta;Oomycetes;Pythiales;Pythiaceae;Pythium;Pythium_Clade_D;Pythium_periplocum
Pythium_periplocum_CBS28931	Heterokontophyta;Oomycetes;Pythiales;Pythiaceae;Pythium;Pythium_Clade_D;Pythium_periplocum
Pythium_perplexum_BR984	Heterokontophyta;Oomycetes;Pythiales;Pythiaceae;Pythium;Pythium_Clade_J;Pythium_perplexum
Pythium_perplexum_CBS67485	Heterokontophyta;Oomycetes;Pythiales;Pythiaceae;Pythium;Pythium_Clade_J;Pythium_perplexum
Pythium_phragmitis_CBS117104	Heterokontophyta;Oomycetes;Pythiales;Pythiaceae;Pythium;Pythium_Clade_B;Pythium_phragmitis
Pythium_pleroticum_CBS77681	Heterokontophyta;Oomycetes;Pythiales;Pythiaceae;Pythium;Pythium_Clade_E;Pythium_pleroticum
Pythium_plurisporium_ADC9824	Heterokontophyta;Oomycetes;Pythiales;Pythiaceae;Pythium;Pythium_Clade_B;Pythium_plurisporium
Pythium_plurisporium_CBS100530	Heterokontophyta;Oomycetes;Pythiales;Pythiaceae;Pythium;Pythium_Clade_B;Pythium_plurisporium
Pythium_polymastum_CBS81170	Heterokontophyta;Oomycetes;Pythiales;Pythiaceae;Pythium;Pythium_Clade_J;Pythium_polymastum
Pythium_porphyrae_CBS36979	Heterokontophyta;Oomycetes;Pythiales;Pythiaceae;Pythium;Pythium_Clade_A;Pythium_porphyrae
Pythium_prolatum_CBS84568	Heterokontophyta;Oomycetes;Pythiales;Pythiaceae;Pythium;Pythium_Clade_H;Pythium_prolatum
Pythium_pyrilobum_CBS15864	Heterokontophyta;Oomycetes;Pythiales;Pythiaceae;Pythium;Pythium_Clade_B;Pythium_pyrilobum
Pythium_radiosum_CBS21794	Heterokontophyta;Oomycetes;Pythiales;Pythiaceae;Pythium;Pythium_Clade_E;Pythium_radiosum
Pythium_rhizooryzae_CBS119169	Heterokontophyta;Oomycetes;Pythiales;Pythiaceae;Pythium;Pythium_Clade_B;Pythium_rhizooryzae
Pythium_rhizosaccharum_CBS112356	Heterokontophyta;Oomycetes;Pythiales;Pythiaceae;Pythium;Pythium_Clade_E;Pythium_rhizosaccharum
Pythium_rhizosaccharum_CBS122652	Heterokontophyta;Oomycetes;Pythiales;Pythiaceae;Pythium;Pythium_Clade_E;Pythium_rhizosaccharum
Pythium_rhizosaccharum_CBS122654	Heterokontophyta;Oomycetes;Pythiales;Pythiaceae;Pythium;Pythium_Clade_E;Pythium_rhizosaccharum
Pythium_rostratifingens_BR1061	Heterokontophyta;Oomycetes;Pythiales;Pythiaceae;Pythium;Pythium_Clade_E;Pythium_rostratifingens
Pythium_rostratifingens_BR197	Heterokontophyta;Oomycetes;Pythiales;Pythiaceae;Pythium;Pythium_Clade_E;Pythium_rostratifingens
Pythium_rostratifingens_BR627	Heterokontophyta;Oomycetes;Pythiales;Pythiaceae;Pythium;Pythium_Clade_E;Pythium_rostratifingens
Pythium_rostratifingens_CBS115464	Heterokontophyta;Oomycetes;Pythiales;Pythiaceae;Pythium;Pythium_Clade_E;Pythium_rostratifingens
Pythium_rostratifingens_CBS38334	Heterokontophyta;Oomycetes;Pythiales;Pythiaceae;Pythium;Pythium_Clade_E;Pythium_rostratifingens
Pythium_rostratifingens_Lev3023	Heterokontophyta;Oomycetes;Pythiales;Pythiaceae;Pythium;Pythium_Clade_E;Pythium_rostratifingens
Pythium_rostratum_CBS53374	Heterokontophyta;Oomycetes;Pythiales;Pythiaceae;Pythium;Pythium_Clade_E;Pythium_rostratum
Pythium_salpingophorum_BR1024	Heterokontophyta;Oomycetes;Pythiales;Pythiaceae;Pythium;Pythium_Clade_B;Pythium_salpingophorum
Pythium_salpingophorum_BR750	Heterokontophyta;Oomycetes;Pythiales;Pythiaceae;Pythium;Pythium_Clade_B;Pythium_salpingophorum
Pythium_salpingophorum_CBS47150	Heterokontophyta;Oomycetes;Pythiales;Pythiaceae;Pythium;Pythium_Clade_B;Pythium_salpingophorum
Pythium_scleroteichum_CBS29437	Heterokontophyta;Oomycetes;Pythiales;Pythiaceae;Pythium;Pythium_Clade_B;Pythium_scleroteichum
Pythium_segnitium_CBS112354	Heterokontophyta;Oomycetes;Pythiales;Pythiaceae;Pythium;Pythium_Clade_E;Pythium_segnitium
Pythium_senticosum_CBS122490	Heterokontophyta;Oomycetes;Pythiales;Pythiaceae;Pythium;Pythium_Clade_H;Pythium_senticosum
Pythium_spiculum_CBS122645	Heterokontophyta;Oomycetes;Pythiales;Pythiaceae;Pythium;Pythium_Clade_F;Pythium_spiculum
Pythium_spinosum_CBS122663	Heterokontophyta;Oomycetes;Pythiales;Pythiaceae;Pythium;Pythium_Clade_F;Pythium_spinosum
Pythium_spinosum_CBS27567	Heterokontophyta;Oomycetes;Pythiales;Pythiaceae;Pythium;Pythium_Clade_F;Pythium_spinosum
Pythium_spinosum_CBS27667	Heterokontophyta;Oomycetes;Pythiales;Pythiaceae;Pythium;Pythium_Clade_F;Pythium_spinosum
Pythium_spinosum_Lev1526	Heterokontophyta;Oomycetes;Pythiales;Pythiaceae;Pythium;Pythium_Clade_F;Pythium_spinosum
Pythium_splendens_BR788	Heterokontophyta;Oomycetes;Pythiales;Pythiaceae;Pythium;Pythium_Clade_I;Pythium_splendens
Pythium_splendens_CBS46248	Heterokontophyta;Oomycetes;Pythiales;Pythiaceae;Pythium;Pythium_Clade_I;Pythium_splendens
Pythium_splendens_Lev1497	Heterokontophyta;Oomycetes;Pythiales;Pythiaceae;Pythium;Pythium_Clade_I;Pythium_splendens
Pythium_sp_balticum_CBS122649	Heterokontophyta;Oomycetes;Pythiales;Pythiaceae;Pythium;Pythium_Clade_F;Pythium_sp_balticum
Pythium_sp_GroupF_ADC0014	Heterokontophyta;Oomycetes;Pythiales;Pythiaceae;Pythium;Pythium_Clade_B;Pythium_sp_GroupF
Pythium_sp_GroupF_ADC9425	Heterokontophyta;Oomycetes;Pythiales;Pythiaceae;Pythium;Pythium_Clade_B;Pythium_sp_GroupF
Pythium_sp_GroupF_ADC9426	Heterokontophyta;Oomycetes;Pythiales;Pythiaceae;Pythium;Pythium_Clade_B;Pythium_sp_GroupF
Pythium_sp_GroupF_ADC9518	Heterokontophyta;Oomycetes;Pythiales;Pythiaceae;Pythium;Pythium_Clade_B;Pythium_sp_GroupF
Pythium_sp_GroupF_ADC9989	Heterokontophyta;Oomycetes;Pythiales;Pythiaceae;Pythium;Pythium_Clade_B;Pythium_sp_GroupF
Pythium_sp_GroupF_BR1041	Heterokontophyta;Oomycetes;Pythiales;Pythiaceae;Pythium;Pythium_Clade_B;Pythium_sp_GroupF
Pythium_sp_GroupF_BR1044	Heterokontophyta;Oomycetes;Pythiales;Pythiaceae;Pythium;Pythium_Clade_B;Pythium_sp_GroupF
Pythium_sp_GroupF_BR710	Heterokontophyta;Oomycetes;Pythiales;Pythiaceae;Pythium;Pythium_Clade_B;Pythium_sp_GroupF
Pythium_sp_GroupF_BR739	Heterokontophyta;Oomycetes;Pythiales;Pythiaceae;Pythium;Pythium_Clade_B;Pythium_sp_GroupF
Pythium_sp_GroupF_BR777	Heterokontophyta;Oomycetes;Pythiales;Pythiaceae;Pythium;Pythium_Clade_B;Pythium_sp_GroupF
Pythium_sp_jasmonium_CBS101876	Heterokontophyta;Oomycetes;Pythiales;Pythiaceae;Pythium;Pythium_Clade_J;Pythium_sp_jasmonium
Pythium_sp_jasmonium_DAOM229150	Heterokontophyta;Oomycetes;Pythiales;Pythiaceae;Pythium;Pythium_Clade_J;Pythium_sp_jasmonium
Pythium_sp_spiculacarpum_CBS122647	Heterokontophyta;Oomycetes;Pythiales;Pythiaceae;Pythium;Pythium_Clade_D;Pythium_sp_spiculacarpum
Pythium_sp_tumidum_CBS22394	Heterokontophyta;Oomycetes;Pythiales;Pythiaceae;Pythium;Pythium_Clade_B;Pythium_sp_tumidum
Pythium_sp_CBS113341	Heterokontophyta;Oomycetes;Pythiales;Pythiaceae;Pythium;Pythium_Clade_F;Pythium_sp
Pythium_sp_CBS75096	Heterokontophyta;Oomycetes;Pythiales;Pythiaceae;Pythium;Pythium_Clade_F;Pythium_sp
Pythium_sp_nov_ADC0013	Heterokontophyta;Oomycetes;Pythiales;Pythiaceae;Pythium;Pythium_sp_nov;Pythium_sp_nov
Pythium_sp_nov_ADC0110	Heterokontophyta;Oomycetes;Pythiales;Pythiaceae;Pythium;Pythium_sp_nov;Pythium_sp_nov
Pythium_sp_nov_ADC0111	Heterokontophyta;Oomycetes;Pythiales;Pythiaceae;Pythium;Pythium_sp_nov;Pythium_sp_nov
Pythium_sp_nov_ADC9407	Heterokontophyta;Oomycetes;Pythiales;Pythiaceae;Pythium;Pythium_sp_nov;Pythium_sp_nov
Pythium_sp_nov_ADC9409	Heterokontophyta;Oomycetes;Pythiales;Pythiaceae;Pythium;Pythium_sp_nov;Pythium_sp_nov
Pythium_sp_nov_ADC9421	Heterokontophyta;Oomycetes;Pythiales;Pythiaceae;Pythium;Pythium_sp_nov;Pythium_sp_nov
Pythium_sp_nov_ADC9759	Heterokontophyta;Oomycetes;Pythiales;Pythiaceae;Pythium;Pythium_sp_nov;Pythium_sp_nov
Pythium_sp_nov_ADC9966	Heterokontophyta;Oomycetes;Pythiales;Pythiaceae;Pythium;Pythium_sp_nov;Pythium_sp_nov
Pythium_sp_nov_ADC9982	Heterokontophyta;Oomycetes;Pythiales;Pythiaceae;Pythium;Pythium_sp_nov;Pythium_sp_nov
Pythium_sp_nov_BR1033	Heterokontophyta;Oomycetes;Pythiales;Pythiaceae;Pythium;Pythium_sp_nov;Pythium_sp_nov
Pythium_sp_nov_BR1034	Heterokontophyta;Oomycetes;Pythiales;Pythiaceae;Pythium;Pythium_sp_nov;Pythium_sp_nov
Pythium_sp_nov_BR1047	Heterokontophyta;Oomycetes;Pythiales;Pythiaceae;Pythium;Pythium_sp_nov;Pythium_sp_nov
Pythium_sp_nov_BR1062	Heterokontophyta;Oomycetes;Pythiales;Pythiaceae;Pythium;Pythium_sp_nov;Pythium_sp_nov
Pythium_sp_nov_BR147	Heterokontophyta;Oomycetes;Pythiales;Pythiaceae;Pythium;Pythium_sp_nov;Pythium_sp_nov
Pythium_sp_nov_BR205	Heterokontophyta;Oomycetes;Pythiales;Pythiaceae;Pythium;Pythium_sp_nov;Pythium_sp_nov
Pythium_sp_nov_BR574	Heterokontophyta;Oomycetes;Pythiales;Pythiaceae;Pythium;Pythium_sp_nov;Pythium_sp_nov
Pythium_sp_nov_BR613	Heterokontophyta;Oomycetes;Pythiales;Pythiaceae;Pythium;Pythium_sp_nov;Pythium_sp_nov
Pythium_sp_nov_BR655	Heterokontophyta;Oomycetes;Pythiales;Pythiaceae;Pythium;Pythium_sp_nov;Pythium_sp_nov
Pythium_sp_nov_BR688	Heterokontophyta;Oomycetes;Pythiales;Pythiaceae;Pythium;Pythium_sp_nov;Pythium_sp_nov
Pythium_sp_nov_BR706	Heterokontophyta;Oomycetes;Pythiales;Pythiaceae;Pythium;Pythium_sp_nov;Pythium_sp_nov
Pythium_sp_nov_BR779	Heterokontophyta;Oomycetes;Pythiales;Pythiaceae;Pythium;Pythium_sp_nov;Pythium_sp_nov
Pythium_sp_nov_BR798	Heterokontophyta;Oomycetes;Pythiales;Pythiaceae;Pythium;Pythium_sp_nov;Pythium_sp_nov
Pythium_sp_nov_BR879	Heterokontophyta;Oomycetes;Pythiales;Pythiaceae;Pythium;Pythium_sp_nov;Pythium_sp_nov
Pythium_sp_nov_BR887	Heterokontophyta;Oomycetes;Pythiales;Pythiaceae;Pythium;Pythium_sp_nov;Pythium_sp_nov
Pythium_sp_nov_BR901	Heterokontophyta;Oomycetes;Pythiales;Pythiaceae;Pythium;Pythium_sp_nov;Pythium_sp_nov
Pythium_sp_nov_BR902	Heterokontophyta;Oomycetes;Pythiales;Pythiaceae;Pythium;Pythium_sp_nov;Pythium_sp_nov
Pythium_sp_nov_BR951	Heterokontophyta;Oomycetes;Pythiales;Pythiaceae;Pythium;Pythium_sp_nov;Pythium_sp_nov
Pythium_sp_nov_CBS23294	Heterokontophyta;Oomycetes;Pythiales;Pythiaceae;Pythium;Pythium_sp_nov;Pythium_sp_nov
Pythium_sp_nov_CBS60781	Heterokontophyta;Oomycetes;Pythiales;Pythiaceae;Pythium;Pythium_sp_nov;Pythium_sp_nov
Pythium_sp_nov_CBS63385	Heterokontophyta;Oomycetes;Pythiales;Pythiaceae;Pythium;Pythium_sp_nov;Pythium_sp_nov
Pythium_sp_nov_DAOM229155	Heterokontophyta;Oomycetes;Pythiales;Pythiaceae;Pythium;Pythium_sp_nov;Pythium_sp_nov
Pythium_sp_nov_Lev1457	Heterokontophyta;Oomycetes;Pythiales;Pythiaceae;Pythium;Pythium_sp_nov;Pythium_sp_nov
Pythium_sp_nov_Lev1523	Heterokontophyta;Oomycetes;Pythiales;Pythiaceae;Pythium;Pythium_sp_nov;Pythium_sp_nov
Pythium_sp_nov_Lev2156	Heterokontophyta;Oomycetes;Pythiales;Pythiaceae;Pythium;Pythium_sp_nov;Pythium_sp_nov
Pythium_sp_nov_Lev2168	Heterokontophyta;Oomycetes;Pythiales;Pythiaceae;Pythium;Pythium_sp_nov;Pythium_sp_nov
Pythium_sp_nov_Lev3062	Heterokontophyta;Oomycetes;Pythiales;Pythiaceae;Pythium;Pythium_sp_nov;Pythium_sp_nov
Pythium_sp_nov_Lev3063	Heterokontophyta;Oomycetes;Pythiales;Pythiaceae;Pythium;Pythium_sp_nov;Pythium_sp_nov
Pythium_sp_nov_Lev3106	Heterokontophyta;Oomycetes;Pythiales;Pythiaceae;Pythium;Pythium_sp_nov;Pythium_sp_nov
Pythium_sp_nov_P16024	Heterokontophyta;Oomycetes;Pythiales;Pythiaceae;Pythium;Pythium_sp_nov;Pythium_sp_nov
Pythium_sp_nov_P19400	Heterokontophyta;Oomycetes;Pythiales;Pythiaceae;Pythium;Pythium_sp_nov;Pythium_sp_nov
Pythium_sp_nov_P19448	Heterokontophyta;Oomycetes;Pythiales;Pythiaceae;Pythium;Pythium_sp_nov;Pythium_sp_nov
Pythium_sp_nov_P19510	Heterokontophyta;Oomycetes;Pythiales;Pythiaceae;Pythium;Pythium_sp_nov;Pythium_sp_nov
Pythium_sp_nov_P8201	Heterokontophyta;Oomycetes;Pythiales;Pythiaceae;Pythium;Pythium_sp_nov;Pythium_sp_nov
Pythium_sp_nov_P8204	Heterokontophyta;Oomycetes;Pythiales;Pythiaceae;Pythium;Pythium_sp_nov;Pythium_sp_nov
Pythium_sp_nov_P8207	Heterokontophyta;Oomycetes;Pythiales;Pythiaceae;Pythium;Pythium_sp_nov;Pythium_sp_nov
Pythium_sp_nov_P8209	Heterokontophyta;Oomycetes;Pythiales;Pythiaceae;Pythium;Pythium_sp_nov;Pythium_sp_nov
Pythium_sp_nov_P8212	Heterokontophyta;Oomycetes;Pythiales;Pythiaceae;Pythium;Pythium_sp_nov;Pythium_sp_nov
Pythium_sukuiense_CBS110030	Heterokontophyta;Oomycetes;Pythiales;Pythiaceae;Pythium;Pythium_Clade_B;Pythium_sukuiense
Pythium_sulcatum_BR113	Heterokontophyta;Oomycetes;Pythiales;Pythiaceae;Pythium;Pythium_Clade_B;Pythium_sulcatum
Pythium_sulcatum_BR146	Heterokontophyta;Oomycetes;Pythiales;Pythiaceae;Pythium;Pythium_Clade_B;Pythium_sulcatum
Pythium_sulcatum_BR652	Heterokontophyta;Oomycetes;Pythiales;Pythiaceae;Pythium;Pythium_Clade_B;Pythium_sulcatum
Pythium_sulcatum_BR653	Heterokontophyta;Oomycetes;Pythiales;Pythiaceae;Pythium;Pythium_Clade_B;Pythium_sulcatum
Pythium_sulcatum_BR708	Heterokontophyta;Oomycetes;Pythiales;Pythiaceae;Pythium;Pythium_Clade_B;Pythium_sulcatum
Pythium_sulcatum_BR709	Heterokontophyta;Oomycetes;Pythiales;Pythiaceae;Pythium;Pythium_Clade_B;Pythium_sulcatum
Pythium_sulcatum_CBS60373	Heterokontophyta;Oomycetes;Pythiales;Pythiaceae;Pythium;Pythium_Clade_B;Pythium_sulcatum
Pythium_sulcatum_Lev3111	Heterokontophyta;Oomycetes;Pythiales;Pythiaceae;Pythium;Pythium_Clade_B;Pythium_sulcatum
Pythium_sylvaticum_BR1045	Heterokontophyta;Oomycetes;Pythiales;Pythiaceae;Pythium;Pythium_Clade_F;Pythium_sylvaticum
Pythium_sylvaticum_BR1069	Heterokontophyta;Oomycetes;Pythiales;Pythiaceae;Pythium;Pythium_Clade_F;Pythium_sylvaticum
Pythium_sylvaticum_BR171	Heterokontophyta;Oomycetes;Pythiales;Pythiaceae;Pythium;Pythium_Clade_F;Pythium_sylvaticum
Pythium_sylvaticum_BR179	Heterokontophyta;Oomycetes;Pythiales;Pythiaceae;Pythium;Pythium_Clade_F;Pythium_sylvaticum
Pythium_sylvaticum_BR599	Heterokontophyta;Oomycetes;Pythiales;Pythiaceae;Pythium;Pythium_Clade_F;Pythium_sylvaticum
Pythium_sylvaticum_BR647	Heterokontophyta;Oomycetes;Pythiales;Pythiaceae;Pythium;Pythium_Clade_F;Pythium_sylvaticum
Pythium_sylvaticum_CBS45367	Heterokontophyta;Oomycetes;Pythiales;Pythiaceae;Pythium;Pythium_Clade_F;Pythium_sylvaticum
Pythium_sylvaticum_Lev1544	Heterokontophyta;Oomycetes;Pythiales;Pythiaceae;Pythium;Pythium_Clade_F;Pythium_sylvaticum
Pythium_sylvaticum_P15580	Heterokontophyta;Oomycetes;Pythiales;Pythiaceae;Pythium;Pythium_Clade_F;Pythium_sylvaticum
Pythium_takayamanum_CBS122491	Heterokontophyta;Oomycetes;Pythiales;Pythiaceae;Pythium;Pythium_Clade_E;Pythium_takayamanum
Pythium_takayamanum_CBS122492	Heterokontophyta;Oomycetes;Pythiales;Pythiaceae;Pythium;Pythium_Clade_E;Pythium_takayamanum
Pythium_tardicrescens_Lev1534	Heterokontophyta;Oomycetes;Pythiales;Pythiaceae;Pythium;Pythium_Clade_B;Pythium_tardicrescens
Pythium_terrestris_ADC9906	Heterokontophyta;Oomycetes;Pythiales;Pythiaceae;Pythium;Pythium_Clade_F;Pythium_terrestris
Pythium_terrestris_BR922	Heterokontophyta;Oomycetes;Pythiales;Pythiaceae;Pythium;Pythium_Clade_F;Pythium_terrestris
Pythium_terrestris_CBS112352	Heterokontophyta;Oomycetes;Pythiales;Pythiaceae;Pythium;Pythium_Clade_F;Pythium_terrestris
Pythium_torulosum_CBS31633	Heterokontophyta;Oomycetes;Pythiales;Pythiaceae;Pythium;Pythium_Clade_B;Pythium_torulosum
Pythium_tracheiphilum_BR659	Heterokontophyta;Oomycetes;Pythiales;Pythiaceae;Pythium;Pythium_Clade_B;Pythium_tracheiphilum
Pythium_tracheiphilum_BR931	Heterokontophyta;Oomycetes;Pythiales;Pythiaceae;Pythium;Pythium_Clade_B;Pythium_tracheiphilum
Pythium_tracheiphilum_BR932	Heterokontophyta;Oomycetes;Pythiales;Pythiaceae;Pythium;Pythium_Clade_B;Pythium_tracheiphilum
Pythium_tracheiphilum_CBS32365	Heterokontophyta;Oomycetes;Pythiales;Pythiaceae;Pythium;Pythium_Clade_B;Pythium_tracheiphilum
Pythium_ultimum_var_sporangiiferum_BR651	Heterokontophyta;Oomycetes;Pythiales;Pythiaceae;Pythium;Pythium_Clade_I;Pythium_ultimum_var_sporangiiferum
Pythium_ultimum_var_sporangiiferum_CBS21965	Heterokontophyta;Oomycetes;Pythiales;Pythiaceae;Pythium;Pythium_Clade_I;Pythium_ultimum_var_sporangiiferum
Pythium_ultimum_var_ultimum_ADC9967	Heterokontophyta;Oomycetes;Pythiales;Pythiaceae;Pythium;Pythium_Clade_I;Pythium_ultimum_var_ultimum
Pythium_ultimum_var_ultimum_BR1036	Heterokontophyta;Oomycetes;Pythiales;Pythiaceae;Pythium;Pythium_Clade_I;Pythium_ultimum_var_ultimum
Pythium_ultimum_var_ultimum_BR1037	Heterokontophyta;Oomycetes;Pythiales;Pythiaceae;Pythium;Pythium_Clade_I;Pythium_ultimum_var_ultimum
Pythium_ultimum_var_ultimum_BR1038	Heterokontophyta;Oomycetes;Pythiales;Pythiaceae;Pythium;Pythium_Clade_I;Pythium_ultimum_var_ultimum
Pythium_ultimum_var_ultimum_BR1054	Heterokontophyta;Oomycetes;Pythiales;Pythiaceae;Pythium;Pythium_Clade_I;Pythium_ultimum_var_ultimum
Pythium_ultimum_var_ultimum_BR1060	Heterokontophyta;Oomycetes;Pythiales;Pythiaceae;Pythium;Pythium_Clade_I;Pythium_ultimum_var_ultimum
Pythium_ultimum_var_ultimum_BR1064	Heterokontophyta;Oomycetes;Pythiales;Pythiaceae;Pythium;Pythium_Clade_I;Pythium_ultimum_var_ultimum
Pythium_ultimum_var_ultimum_BR1065	Heterokontophyta;Oomycetes;Pythiales;Pythiaceae;Pythium;Pythium_Clade_I;Pythium_ultimum_var_ultimum
Pythium_ultimum_var_ultimum_BR1089	Heterokontophyta;Oomycetes;Pythiales;Pythiaceae;Pythium;Pythium_Clade_I;Pythium_ultimum_var_ultimum
Pythium_ultimum_var_ultimum_BR144	Heterokontophyta;Oomycetes;Pythiales;Pythiaceae;Pythium;Pythium_Clade_I;Pythium_ultimum_var_ultimum
Pythium_ultimum_var_ultimum_BR229	Heterokontophyta;Oomycetes;Pythiales;Pythiaceae;Pythium;Pythium_Clade_I;Pythium_ultimum_var_ultimum
Pythium_ultimum_var_ultimum_BR319	Heterokontophyta;Oomycetes;Pythiales;Pythiaceae;Pythium;Pythium_Clade_I;Pythium_ultimum_var_ultimum
Pythium_ultimum_var_ultimum_BR511	Heterokontophyta;Oomycetes;Pythiales;Pythiaceae;Pythium;Pythium_Clade_I;Pythium_ultimum_var_ultimum
Pythium_ultimum_var_ultimum_BR583	Heterokontophyta;Oomycetes;Pythiales;Pythiaceae;Pythium;Pythium_Clade_I;Pythium_ultimum_var_ultimum
Pythium_ultimum_var_ultimum_BR600	Heterokontophyta;Oomycetes;Pythiales;Pythiaceae;Pythium;Pythium_Clade_I;Pythium_ultimum_var_ultimum
Pythium_ultimum_var_ultimum_BR612	Heterokontophyta;Oomycetes;Pythiales;Pythiaceae;Pythium;Pythium_Clade_I;Pythium_ultimum_var_ultimum
Pythium_ultimum_var_ultimum_BR628	Heterokontophyta;Oomycetes;Pythiales;Pythiaceae;Pythium;Pythium_Clade_I;Pythium_ultimum_var_ultimum
Pythium_ultimum_var_ultimum_BR640	Heterokontophyta;Oomycetes;Pythiales;Pythiaceae;Pythium;Pythium_Clade_I;Pythium_ultimum_var_ultimum
Pythium_ultimum_var_ultimum_BR656	Heterokontophyta;Oomycetes;Pythiales;Pythiaceae;Pythium;Pythium_Clade_I;Pythium_ultimum_var_ultimum
Pythium_ultimum_var_ultimum_BR657	Heterokontophyta;Oomycetes;Pythiales;Pythiaceae;Pythium;Pythium_Clade_I;Pythium_ultimum_var_ultimum
Pythium_ultimum_var_ultimum_BR658	Heterokontophyta;Oomycetes;Pythiales;Pythiaceae;Pythium;Pythium_Clade_I;Pythium_ultimum_var_ultimum
Pythium_ultimum_var_ultimum_BR718	Heterokontophyta;Oomycetes;Pythiales;Pythiaceae;Pythium;Pythium_Clade_I;Pythium_ultimum_var_ultimum
Pythium_ultimum_var_ultimum_BR736	Heterokontophyta;Oomycetes;Pythiales;Pythiaceae;Pythium;Pythium_Clade_I;Pythium_ultimum_var_ultimum
Pythium_ultimum_var_ultimum_BR737	Heterokontophyta;Oomycetes;Pythiales;Pythiaceae;Pythium;Pythium_Clade_I;Pythium_ultimum_var_ultimum
Pythium_ultimum_var_ultimum_BR738	Heterokontophyta;Oomycetes;Pythiales;Pythiaceae;Pythium;Pythium_Clade_I;Pythium_ultimum_var_ultimum
Pythium_ultimum_var_ultimum_BR745	Heterokontophyta;Oomycetes;Pythiales;Pythiaceae;Pythium;Pythium_Clade_I;Pythium_ultimum_var_ultimum
Pythium_ultimum_var_ultimum_BR747	Heterokontophyta;Oomycetes;Pythiales;Pythiaceae;Pythium;Pythium_Clade_I;Pythium_ultimum_var_ultimum
Pythium_ultimum_var_ultimum_BR748	Heterokontophyta;Oomycetes;Pythiales;Pythiaceae;Pythium;Pythium_Clade_I;Pythium_ultimum_var_ultimum
Pythium_ultimum_var_ultimum_BR754	Heterokontophyta;Oomycetes;Pythiales;Pythiaceae;Pythium;Pythium_Clade_I;Pythium_ultimum_var_ultimum
Pythium_ultimum_var_ultimum_BR755	Heterokontophyta;Oomycetes;Pythiales;Pythiaceae;Pythium;Pythium_Clade_I;Pythium_ultimum_var_ultimum
Pythium_ultimum_var_ultimum_BR759	Heterokontophyta;Oomycetes;Pythiales;Pythiaceae;Pythium;Pythium_Clade_I;Pythium_ultimum_var_ultimum
Pythium_ultimum_var_ultimum_BR760	Heterokontophyta;Oomycetes;Pythiales;Pythiaceae;Pythium;Pythium_Clade_I;Pythium_ultimum_var_ultimum
Pythium_ultimum_var_ultimum_BR763	Heterokontophyta;Oomycetes;Pythiales;Pythiaceae;Pythium;Pythium_Clade_I;Pythium_ultimum_var_ultimum
Pythium_ultimum_var_ultimum_BR768	Heterokontophyta;Oomycetes;Pythiales;Pythiaceae;Pythium;Pythium_Clade_I;Pythium_ultimum_var_ultimum
Pythium_ultimum_var_ultimum_BR776	Heterokontophyta;Oomycetes;Pythiales;Pythiaceae;Pythium;Pythium_Clade_I;Pythium_ultimum_var_ultimum
Pythium_ultimum_var_ultimum_BR781	Heterokontophyta;Oomycetes;Pythiales;Pythiaceae;Pythium;Pythium_Clade_I;Pythium_ultimum_var_ultimum
Pythium_ultimum_var_ultimum_BR783	Heterokontophyta;Oomycetes;Pythiales;Pythiaceae;Pythium;Pythium_Clade_I;Pythium_ultimum_var_ultimum
Pythium_ultimum_var_ultimum_BR784	Heterokontophyta;Oomycetes;Pythiales;Pythiaceae;Pythium;Pythium_Clade_I;Pythium_ultimum_var_ultimum
Pythium_ultimum_var_ultimum_BR792	Heterokontophyta;Oomycetes;Pythiales;Pythiaceae;Pythium;Pythium_Clade_I;Pythium_ultimum_var_ultimum
Pythium_ultimum_var_ultimum_BR793	Heterokontophyta;Oomycetes;Pythiales;Pythiaceae;Pythium;Pythium_Clade_I;Pythium_ultimum_var_ultimum
Pythium_ultimum_var_ultimum_BR810	Heterokontophyta;Oomycetes;Pythiales;Pythiaceae;Pythium;Pythium_Clade_I;Pythium_ultimum_var_ultimum
Pythium_ultimum_var_ultimum_BR813	Heterokontophyta;Oomycetes;Pythiales;Pythiaceae;Pythium;Pythium_Clade_I;Pythium_ultimum_var_ultimum
Pythium_ultimum_var_ultimum_BR814	Heterokontophyta;Oomycetes;Pythiales;Pythiaceae;Pythium;Pythium_Clade_I;Pythium_ultimum_var_ultimum
Pythium_ultimum_var_ultimum_BR816	Heterokontophyta;Oomycetes;Pythiales;Pythiaceae;Pythium;Pythium_Clade_I;Pythium_ultimum_var_ultimum
Pythium_ultimum_var_ultimum_BR822	Heterokontophyta;Oomycetes;Pythiales;Pythiaceae;Pythium;Pythium_Clade_I;Pythium_ultimum_var_ultimum
Pythium_ultimum_var_ultimum_BR823	Heterokontophyta;Oomycetes;Pythiales;Pythiaceae;Pythium;Pythium_Clade_I;Pythium_ultimum_var_ultimum
Pythium_ultimum_var_ultimum_BR824	Heterokontophyta;Oomycetes;Pythiales;Pythiaceae;Pythium;Pythium_Clade_I;Pythium_ultimum_var_ultimum
Pythium_ultimum_var_ultimum_BR825	Heterokontophyta;Oomycetes;Pythiales;Pythiaceae;Pythium;Pythium_Clade_I;Pythium_ultimum_var_ultimum
Pythium_ultimum_var_ultimum_BR826	Heterokontophyta;Oomycetes;Pythiales;Pythiaceae;Pythium;Pythium_Clade_I;Pythium_ultimum_var_ultimum
Pythium_ultimum_var_ultimum_BR827	Heterokontophyta;Oomycetes;Pythiales;Pythiaceae;Pythium;Pythium_Clade_I;Pythium_ultimum_var_ultimum
Pythium_ultimum_var_ultimum_BR833	Heterokontophyta;Oomycetes;Pythiales;Pythiaceae;Pythium;Pythium_Clade_I;Pythium_ultimum_var_ultimum
Pythium_ultimum_var_ultimum_BR835	Heterokontophyta;Oomycetes;Pythiales;Pythiaceae;Pythium;Pythium_Clade_I;Pythium_ultimum_var_ultimum
Pythium_ultimum_var_ultimum_BR841	Heterokontophyta;Oomycetes;Pythiales;Pythiaceae;Pythium;Pythium_Clade_I;Pythium_ultimum_var_ultimum
Pythium_ultimum_var_ultimum_BR842	Heterokontophyta;Oomycetes;Pythiales;Pythiaceae;Pythium;Pythium_Clade_I;Pythium_ultimum_var_ultimum
Pythium_ultimum_var_ultimum_BR843	Heterokontophyta;Oomycetes;Pythiales;Pythiaceae;Pythium;Pythium_Clade_I;Pythium_ultimum_var_ultimum
Pythium_ultimum_var_ultimum_BR844	Heterokontophyta;Oomycetes;Pythiales;Pythiaceae;Pythium;Pythium_Clade_I;Pythium_ultimum_var_ultimum
Pythium_ultimum_var_ultimum_BR845	Heterokontophyta;Oomycetes;Pythiales;Pythiaceae;Pythium;Pythium_Clade_I;Pythium_ultimum_var_ultimum
Pythium_ultimum_var_ultimum_BR847	Heterokontophyta;Oomycetes;Pythiales;Pythiaceae;Pythium;Pythium_Clade_I;Pythium_ultimum_var_ultimum
Pythium_ultimum_var_ultimum_BR848	Heterokontophyta;Oomycetes;Pythiales;Pythiaceae;Pythium;Pythium_Clade_I;Pythium_ultimum_var_ultimum
Pythium_ultimum_var_ultimum_BR849	Heterokontophyta;Oomycetes;Pythiales;Pythiaceae;Pythium;Pythium_Clade_I;Pythium_ultimum_var_ultimum
Pythium_ultimum_var_ultimum_BR850	Heterokontophyta;Oomycetes;Pythiales;Pythiaceae;Pythium;Pythium_Clade_I;Pythium_ultimum_var_ultimum
Pythium_ultimum_var_ultimum_BR851	Heterokontophyta;Oomycetes;Pythiales;Pythiaceae;Pythium;Pythium_Clade_I;Pythium_ultimum_var_ultimum
Pythium_ultimum_var_ultimum_BR854	Heterokontophyta;Oomycetes;Pythiales;Pythiaceae;Pythium;Pythium_Clade_I;Pythium_ultimum_var_ultimum
Pythium_ultimum_var_ultimum_BR858	Heterokontophyta;Oomycetes;Pythiales;Pythiaceae;Pythium;Pythium_Clade_I;Pythium_ultimum_var_ultimum
Pythium_ultimum_var_ultimum_BR861	Heterokontophyta;Oomycetes;Pythiales;Pythiaceae;Pythium;Pythium_Clade_I;Pythium_ultimum_var_ultimum
Pythium_ultimum_var_ultimum_BR863	Heterokontophyta;Oomycetes;Pythiales;Pythiaceae;Pythium;Pythium_Clade_I;Pythium_ultimum_var_ultimum
Pythium_ultimum_var_ultimum_BR864	Heterokontophyta;Oomycetes;Pythiales;Pythiaceae;Pythium;Pythium_Clade_I;Pythium_ultimum_var_ultimum
Pythium_ultimum_var_ultimum_BR867	Heterokontophyta;Oomycetes;Pythiales;Pythiaceae;Pythium;Pythium_Clade_I;Pythium_ultimum_var_ultimum
Pythium_ultimum_var_ultimum_BR930	Heterokontophyta;Oomycetes;Pythiales;Pythiaceae;Pythium;Pythium_Clade_I;Pythium_ultimum_var_ultimum
Pythium_ultimum_var_ultimum_BR944	Heterokontophyta;Oomycetes;Pythiales;Pythiaceae;Pythium;Pythium_Clade_I;Pythium_ultimum_var_ultimum
Pythium_ultimum_var_ultimum_BR987	Heterokontophyta;Oomycetes;Pythiales;Pythiaceae;Pythium;Pythium_Clade_I;Pythium_ultimum_var_ultimum
Pythium_ultimum_var_ultimum_BR988	Heterokontophyta;Oomycetes;Pythiales;Pythiaceae;Pythium;Pythium_Clade_I;Pythium_ultimum_var_ultimum
Pythium_ultimum_var_ultimum_CBS122650	Heterokontophyta;Oomycetes;Pythiales;Pythiaceae;Pythium;Pythium_Clade_I;Pythium_ultimum_var_ultimum
Pythium_ultimum_var_ultimum_CBS39851	Heterokontophyta;Oomycetes;Pythiales;Pythiaceae;Pythium;Pythium_Clade_I;Pythium_ultimum_var_ultimum
Pythium_ultimum_var_ultimum_CBS72994	Heterokontophyta;Oomycetes;Pythiales;Pythiaceae;Pythium;Pythium_Clade_I;Pythium_ultimum_var_ultimum
Pythium_ultimum_var_ultimum_DAOM232337	Heterokontophyta;Oomycetes;Pythiales;Pythiaceae;Pythium;Pythium_Clade_I;Pythium_ultimum_var_ultimum
Pythium_ultimum_var_ultimum_Lev1441	Heterokontophyta;Oomycetes;Pythiales;Pythiaceae;Pythium;Pythium_Clade_I;Pythium_ultimum_var_ultimum
Pythium_ultimum_var_ultimum_Lev1442	Heterokontophyta;Oomycetes;Pythiales;Pythiaceae;Pythium;Pythium_Clade_I;Pythium_ultimum_var_ultimum
Pythium_uncinulatum_ADC0108	Heterokontophyta;Oomycetes;Pythiales;Pythiaceae;Pythium;Pythium_Clade_J;Pythium_uncinulatum
Pythium_uncinulatum_CBS51877	Heterokontophyta;Oomycetes;Pythiales;Pythiaceae;Pythium;Pythium_Clade_J;Pythium_uncinulatum
Pythium_undulatum_ADC9929	Heterokontophyta;Oomycetes;Pythiales;Pythiaceae;Pythium;Pythium_Clade_H;Pythium_undulatum
Pythium_undulatum_CBS15769	Heterokontophyta;Oomycetes;Pythiales;Pythiaceae;Pythium;Pythium_Clade_H;Pythium_undulatum
Pythium_undulatum_CBS32347	Heterokontophyta;Oomycetes;Pythiales;Pythiaceae;Pythium;Pythium_Clade_H;Pythium_undulatum
Pythium_undulatum_Lev1232	Heterokontophyta;Oomycetes;Pythiales;Pythiaceae;Pythium;Pythium_Clade_H;Pythium_undulatum
Pythium_vanterpoolii_CBS11577	Heterokontophyta;Oomycetes;Pythiales;Pythiaceae;Pythium;Pythium_Clade_B;Pythium_vanterpoolii
Pythium_vanterpoolii_CBS29537	Heterokontophyta;Oomycetes;Pythiales;Pythiaceae;Pythium;Pythium_Clade_B;Pythium_vanterpoolii
Pythium_vanterpoolii_CBS43191	Heterokontophyta;Oomycetes;Pythiales;Pythiaceae;Pythium;Pythium_Clade_B;Pythium_vanterpoolii
Pythium_vanterpoolii_Lev1536	Heterokontophyta;Oomycetes;Pythiales;Pythiaceae;Pythium;Pythium_Clade_B;Pythium_vanterpoolii
Pythium_viniferum_CBS119168	Heterokontophyta;Oomycetes;Pythiales;Pythiaceae;Pythium;Pythium_Clade_F;Pythium_viniferum
Pythium_violae_ADC9739	Heterokontophyta;Oomycetes;Pythiales;Pythiaceae;Pythium;Pythium_Clade_G;Pythium_violae
Pythium_violae_ADC9754	Heterokontophyta;Oomycetes;Pythiales;Pythiaceae;Pythium;Pythium_Clade_G;Pythium_violae
Pythium_violae_ADC9923	Heterokontophyta;Oomycetes;Pythiales;Pythiaceae;Pythium;Pythium_Clade_G;Pythium_violae
Pythium_violae_ADC9924	Heterokontophyta;Oomycetes;Pythiales;Pythiaceae;Pythium;Pythium_Clade_G;Pythium_violae
Pythium_violae_ADC9974	Heterokontophyta;Oomycetes;Pythiales;Pythiaceae;Pythium;Pythium_Clade_G;Pythium_violae
Pythium_violae_ADC9975	Heterokontophyta;Oomycetes;Pythiales;Pythiaceae;Pythium;Pythium_Clade_G;Pythium_violae
Pythium_violae_BR322	Heterokontophyta;Oomycetes;Pythiales;Pythiaceae;Pythium;Pythium_Clade_G;Pythium_violae
Pythium_violae_CBS15964	Heterokontophyta;Oomycetes;Pythiales;Pythiaceae;Pythium;Pythium_Clade_G;Pythium_violae
Pythium_violae_CBS17886	Heterokontophyta;Oomycetes;Pythiales;Pythiaceae;Pythium;Pythium_Clade_G;Pythium_violae
Pythium_violae_Lev1518	Heterokontophyta;Oomycetes;Pythiales;Pythiaceae;Pythium;Pythium_Clade_G;Pythium_violae
Pythium_violae_Lev1519	Heterokontophyta;Oomycetes;Pythiales;Pythiaceae;Pythium;Pythium_Clade_G;Pythium_violae
Pythium_violae_Lev1604	Heterokontophyta;Oomycetes;Pythiales;Pythiaceae;Pythium;Pythium_Clade_G;Pythium_violae
Pythium_violae_Lev1605	Heterokontophyta;Oomycetes;Pythiales;Pythiaceae;Pythium;Pythium_Clade_G;Pythium_violae
Pythium_volutum_CBS69983	Heterokontophyta;Oomycetes;Pythiales;Pythiaceae;Pythium;Pythium_Clade_B;Pythium_volutum
Pythium_zingiberis_CBS21682	Heterokontophyta;Oomycetes;Pythiales;Pythiaceae;Pythium;Pythium_Clade_B;Pythium_zingiberis
Pythium_zingiberis_CBS21782	Heterokontophyta;Oomycetes;Pythiales;Pythiaceae;Pythium;Pythium_Clade_B;Pythium_zingiberis
Saprolegnia_anisospora_CBS110060	Heterokontophyta;Oomycetes;Saprolegniales;Saprolegniaceae;Saprolegnia;Saprolegnia;Saprolegnia_anisospora
Saprolegnia_asterophora_CBS53167	Heterokontophyta;Oomycetes;Saprolegniales;Saprolegniaceae;Saprolegnia;Saprolegnia;Saprolegnia_asterophora
Saprolegnia_delica_CBS34462	Heterokontophyta;Oomycetes;Saprolegniales;Saprolegniaceae;Saprolegnia;Saprolegnia;Saprolegnia_delica
Saprolegnia_delica_CBS34562	Heterokontophyta;Oomycetes;Saprolegniales;Saprolegniaceae;Saprolegnia;Saprolegnia;Saprolegnia_delica
Saprolegnia_diclina_CBS28238	Heterokontophyta;Oomycetes;Saprolegniales;Saprolegniaceae;Saprolegnia;Saprolegnia;Saprolegnia_diclina
Saprolegnia_diclina_CBS32635	Heterokontophyta;Oomycetes;Saprolegniales;Saprolegniaceae;Saprolegnia;Saprolegnia;Saprolegnia_diclina
Saprolegnia_diclina_CBS53667	Heterokontophyta;Oomycetes;Saprolegniales;Saprolegniaceae;Saprolegnia;Saprolegnia;Saprolegnia_diclina
Saprolegnia_eccentrica_CBS19938	Heterokontophyta;Oomycetes;Saprolegniales;Saprolegniaceae;Saprolegnia;Saprolegnia;Saprolegnia_eccentrica
Saprolegnia_eccentrica_CBS21135	Heterokontophyta;Oomycetes;Saprolegniales;Saprolegniaceae;Saprolegnia;Saprolegnia;Saprolegnia_eccentrica
Saprolegnia_eccentrica_CBS55167	Heterokontophyta;Oomycetes;Saprolegniales;Saprolegniaceae;Saprolegnia;Saprolegnia;Saprolegnia_eccentrica
Saprolegnia_ferax_BR114	Heterokontophyta;Oomycetes;Saprolegniales;Saprolegniaceae;Saprolegnia;Saprolegnia;Saprolegnia_ferax
Saprolegnia_ferax_CBS17342	Heterokontophyta;Oomycetes;Saprolegniales;Saprolegniaceae;Saprolegnia;Saprolegnia;Saprolegnia_ferax
Saprolegnia_ferax_CBS28338	Heterokontophyta;Oomycetes;Saprolegniales;Saprolegniaceae;Saprolegnia;Saprolegnia;Saprolegnia_ferax
Saprolegnia_ferax_CBS30537	Heterokontophyta;Oomycetes;Saprolegniales;Saprolegniaceae;Saprolegnia;Saprolegnia;Saprolegnia_ferax
Saprolegnia_ferax_CBS53467	Heterokontophyta;Oomycetes;Saprolegniales;Saprolegniaceae;Saprolegnia;Saprolegnia;Saprolegnia_ferax
Saprolegnia_hypogyna_CBS86972	Heterokontophyta;Oomycetes;Saprolegniales;Saprolegniaceae;Saprolegnia;Saprolegnia;Saprolegnia_hypogyna
Saprolegnia_lapponica_CBS28438	Heterokontophyta;Oomycetes;Saprolegniales;Saprolegniaceae;Saprolegnia;Saprolegnia;Saprolegnia_lapponica
Saprolegnia_litoralis_CBS110062	Heterokontophyta;Oomycetes;Saprolegniales;Saprolegniaceae;Saprolegnia;Saprolegnia;Saprolegnia_litoralis
Saprolegnia_litoralis_CBS53567	Heterokontophyta;Oomycetes;Saprolegniales;Saprolegniaceae;Saprolegnia;Saprolegnia;Saprolegnia_litoralis
Saprolegnia_megasperma_CBS53267	Heterokontophyta;Oomycetes;Saprolegniales;Saprolegniaceae;Saprolegnia;Saprolegnia;Saprolegnia_megasperma
Saprolegnia_mixta_CBS14965	Heterokontophyta;Oomycetes;Saprolegniales;Saprolegniaceae;Saprolegnia;Saprolegnia;Saprolegnia_mixta
Saprolegnia_mixta_CBS30737	Heterokontophyta;Oomycetes;Saprolegniales;Saprolegniaceae;Saprolegnia;Saprolegnia;Saprolegnia_mixta
Saprolegnia_monilifera_CBS55267	Heterokontophyta;Oomycetes;Saprolegniales;Saprolegniaceae;Saprolegnia;Saprolegnia;Saprolegnia_monilifera
Saprolegnia_monilifera_CBS55867	Heterokontophyta;Oomycetes;Saprolegniales;Saprolegniaceae;Saprolegnia;Saprolegnia;Saprolegnia_monilifera
Saprolegnia_monoica_CBS53967	Heterokontophyta;Oomycetes;Saprolegniales;Saprolegniaceae;Saprolegnia;Saprolegnia;Saprolegnia_monoica
Saprolegnia_monoica_CBS59967	Heterokontophyta;Oomycetes;Saprolegniales;Saprolegniaceae;Saprolegnia;Saprolegnia;Saprolegnia_monoica
Saprolegnia_parasitica_CBS113187	Heterokontophyta;Oomycetes;Saprolegniales;Saprolegniaceae;Saprolegnia;Saprolegnia;Saprolegnia_parasitica
Saprolegnia_parasitica_CBS22365	Heterokontophyta;Oomycetes;Saprolegniales;Saprolegniaceae;Saprolegnia;Saprolegnia;Saprolegnia_parasitica
Saprolegnia_parasitica_CBS30032	Heterokontophyta;Oomycetes;Saprolegniales;Saprolegniaceae;Saprolegnia;Saprolegnia;Saprolegnia_parasitica
Saprolegnia_parasitica_CBS30256	Heterokontophyta;Oomycetes;Saprolegniales;Saprolegniaceae;Saprolegnia;Saprolegnia;Saprolegnia_parasitica
Saprolegnia_parasitica_CBS39734	Heterokontophyta;Oomycetes;Saprolegniales;Saprolegniaceae;Saprolegnia;Saprolegnia;Saprolegnia_parasitica
Saprolegnia_parasitica_CBS54067	Heterokontophyta;Oomycetes;Saprolegniales;Saprolegniaceae;Saprolegnia;Saprolegnia;Saprolegnia_parasitica
Saprolegnia_rodrigueziana_CBS119354	Heterokontophyta;Oomycetes;Saprolegniales;Saprolegniaceae;Saprolegnia;Saprolegnia;Saprolegnia_rodrigueziana
Saprolegnia_sp_CBS63285	Heterokontophyta;Oomycetes;Saprolegniales;Saprolegniaceae;Saprolegnia;Saprolegnia;Saprolegnia_sp
Saprolegnia_subterranea_CBS113343	Heterokontophyta;Oomycetes;Saprolegniales;Saprolegniaceae;Saprolegnia;Saprolegnia;Saprolegnia_subterranea
Saprolegnia_subterranea_CBS27852	Heterokontophyta;Oomycetes;Saprolegniales;Saprolegniaceae;Saprolegnia;Saprolegnia;Saprolegnia_subterranea
Saprolegnia_terrestris_CBS110063	Heterokontophyta;Oomycetes;Saprolegniales;Saprolegniaceae;Saprolegnia;Saprolegnia;Saprolegnia_terrestris
Saprolegnia_terrestris_CBS53367	Heterokontophyta;Oomycetes;Saprolegniales;Saprolegniaceae;Saprolegnia;Saprolegnia;Saprolegnia_terrestris
Saprolegnia_turfosa_CBS110065	Heterokontophyta;Oomycetes;Saprolegniales;Saprolegniaceae;Saprolegnia;Saprolegnia;Saprolegnia_turfosa
Saprolegnia_turfosa_CBS31381	Heterokontophyta;Oomycetes;Saprolegniales;Saprolegniaceae;Saprolegnia;Saprolegnia;Saprolegnia_turfosa
Saprolegnia_turfosa_CBS32735	Heterokontophyta;Oomycetes;Saprolegniales;Saprolegniaceae;Saprolegnia;Saprolegnia;Saprolegnia_turfosa
Saprolegnia_unispora_CBS110066	Heterokontophyta;Oomycetes;Saprolegniales;Saprolegniaceae;Saprolegnia;Saprolegnia;Saprolegnia_unispora
Saprolegnia_unispora_CBS21335	Heterokontophyta;Oomycetes;Saprolegniales;Saprolegniaceae;Saprolegnia;Saprolegnia;Saprolegnia_unispora
Thraustotheca_clavata_CBS34333	Heterokontophyta;Oomycetes;Saprolegniales;Saprolegniaceae;Thraustotheca;Thraustotheca;Thraustotheca_clavata
Thraustotheca_clavata_CBS55767	Heterokontophyta;Oomycetes;Saprolegniales;Saprolegniaceae;Thraustotheca;Thraustotheca;Thraustotheca_clavata
Thraustotheca_terrestris_CBS109851	Heterokontophyta;Oomycetes;Saprolegniales;Saprolegniaceae;Thraustotheca;Thraustotheca;Thraustotheca_terrestris